32 32 
@@@@@@@@@@@@@@@@@@@@@@@@@@@@@@@@
@..@..@.........................
@..@..@.........................
@..@..@..@@@@@@@@@@@@@..@@@@..@.
@.....@..............@..@..@..@.
@.....@..............@..@..@..@.
@..@@@@@@@..@@@@@@@@@@..@..@@@@.
@...........@...........@.....@.
@...........@...........@.....@.
@@@@@@@@@@@@@..@@@@..@@@@..@@@@@
@..............@.....@..@..@....
@..............@.....@..@..@....
@..@@@@@@@@@@@@@@@@@@@..@..@@@@.
@..............@.....@.....@....
@..............@.....@.....@....
@..@@@@@@@..@@@@..@..@@@@..@..@@
@..@........@.....@........@..@.
@..@........@.....@........@..@.
@@@@..@@@@..@..@@@@..@@@@@@@..@.
@.....@.....@..@.....@........@.
@.....@.....@..@.....@........@.
@..@..@@@@@@@..@..@@@@..@@@@@@@.
@..@........@..@..@..@..@.......
@..@........@..@..@..@..@.......
@..@@@@..@@@@..@@@@..@..@@@@@@@.
@..@..@.................@.......
@..@..@.................@.......
@..@..@@@@@@@@@@..@@@@@@@..@@@@.
@..@..@........@..@........@..@.
@..@..@........@..@........@..@.
@..@..@@@@..@..@..@@@@..@@@@..@.
@.....@.....@...........@.......
55 
11 12 30 22 
29 29 1 25 
22 7 2 4 
4 12 22 11 
25 21 26 26 
23 10 4 7 
17 19 7 25 
10 20 13 25 
25 20 30 29 
7 2 1 4 
22 29 31 16 
29 23 13 29 
7 5 27 17 
8 11 4 9 
11 10 8 18 
26 7 7 4 
5 23 20 22 
11 31 25 14 
15 1 7 7 
27 1 16 25 
13 28 5 14 
14 16 1 2 
5 26 4 22 
28 17 11 4 
20 7 25 26 
17 8 31 4 
1 10 19 1 
31 29 19 27 
25 19 10 26 
19 5 27 5 
25 9 25 18 
30 23 19 23 
5 10 4 31 
6 10 23 17 
23 7 5 2 
14 6 5 8 
3 22 7 29 
10 31 11 25 
31 28 11 20 
13 11 5 12 
7 18 31 9 
31 8 1 7 
13 18 13 19 
27 4 1 13 
4 29 13 23 
1 1 28 23 
26 11 11 9 
30 13 7 17 
26 22 9 25 
22 14 4 10 
7 8 21 23 
31 22 13 24 
22 25 26 20 
20 14 1 16 
17 20 14 26 
