63 161 
@ @ @ @ @ @ @ @ @ @ @ @ @ @ @ @ @ @ @ @ @ @ @ @ @ @ @ @ @ @ @ @ @ @ @ @ @ @ @ @ @ @ @ @ @ @ @ @ @ @ @ @ @ @ @ @ @ @ @ @ @ @ @ @ @ @ @ @ @ @ @ @ @ @ @ @ @ @ @ @ @ @ @ @ @ @ @ @ @ @ @ @ @ @ @ @ @ @ @ @ @ @ @ @ @ @ @ @ @ @ @ @ @ @ @ @ @ @ @ @ @ @ @ @ @ @ @ @ @ @ @ @ @ @ @ @ @ @ @ @ @ @ @ @ @ @ @ @ @ @ @ @ @ @ @ @ @ @ @ @ @ 
@ . . . . . . . . . . . . . . . . . . . . . . . . . . . . . . . . . . . . . . . . . . . . . . . . . . . . . . . . . . . . . . . . . . . . . . . . . . . . . . . . . . . . . . . . . . . . . . . . . . . . . . . . . . . . . . . . . . . . . . . . . . . . . . . . . . . . . . . . . . . . . . . . . . . . . . . . . . . . . . . @ 
@ . . . . . . . . . . . . . . . . . . . . . . . . . @ @ @ @ @ @ @ @ @ @ . @ @ @ @ @ @ @ @ @ @ . @ @ @ @ @ @ @ @ @ @ . @ @ @ @ @ @ @ @ @ @ . @ @ @ @ @ @ @ @ @ @ . @ @ @ @ @ @ @ @ @ @ . @ @ @ @ @ @ @ @ @ @ . @ @ @ @ @ @ @ @ @ @ . @ @ @ @ @ @ @ @ @ @ . @ @ @ @ @ @ @ @ @ @ . . . . . . . . . . . . . . . . . . . . . . . . . @ 
@ . . . . . . . . . . . . . . . . . . . . . . . . . @ @ @ @ @ @ @ @ @ @ . @ @ @ @ @ @ @ @ @ @ . @ @ @ @ @ @ @ @ @ @ . @ @ @ @ @ @ @ @ @ @ . @ @ @ @ @ @ @ @ @ @ . @ @ @ @ @ @ @ @ @ @ . @ @ @ @ @ @ @ @ @ @ . @ @ @ @ @ @ @ @ @ @ . @ @ @ @ @ @ @ @ @ @ . @ @ @ @ @ @ @ @ @ @ . . . . . . . . . . . . . . . . . . . . . . . . . @ 
@ . . . . . . . . . . . . . . . . . . . . . . . . . . . . . . . . . . . . . . . . . . . . . . . . . . . . . . . . . . . . . . . . . . . . . . . . . . . . . . . . . . . . . . . . . . . . . . . . . . . . . . . . . . . . . . . . . . . . . . . . . . . . . . . . . . . . . . . . . . . . . . . . . . . . . . . . . . . . . . . @ 
@ . . . . . . . . . . . . . . . . . . . . . . . . . @ @ @ @ @ @ @ @ @ @ . @ @ @ @ @ @ @ @ @ @ . @ @ @ @ @ @ @ @ @ @ . @ @ @ @ @ @ @ @ @ @ . @ @ @ @ @ @ @ @ @ @ . @ @ @ @ @ @ @ @ @ @ . @ @ @ @ @ @ @ @ @ @ . @ @ @ @ @ @ @ @ @ @ . @ @ @ @ @ @ @ @ @ @ . @ @ @ @ @ @ @ @ @ @ . . . . . . . . . . . . . . . . . . . . . . . . . @ 
@ . . . . . . . . . . . . . . . . . . . . . . . . . @ @ @ @ @ @ @ @ @ @ . @ @ @ @ @ @ @ @ @ @ . @ @ @ @ @ @ @ @ @ @ . @ @ @ @ @ @ @ @ @ @ . @ @ @ @ @ @ @ @ @ @ . @ @ @ @ @ @ @ @ @ @ . @ @ @ @ @ @ @ @ @ @ . @ @ @ @ @ @ @ @ @ @ . @ @ @ @ @ @ @ @ @ @ . @ @ @ @ @ @ @ @ @ @ . . . . . . . . . . . . . . . . . . . . . . . . . @ 
@ . . . . . . . . . . . . . . . . . . . . . . . . . . . . . . . . . . . . . . . . . . . . . . . . . . . . . . . . . . . . . . . . . . . . . . . . . . . . . . . . . . . . . . . . . . . . . . . . . . . . . . . . . . . . . . . . . . . . . . . . . . . . . . . . . . . . . . . . . . . . . . . . . . . . . . . . . . . . . . . @ 
@ . . . . . . . . . . . . . . . . . . . . . . . . . @ @ @ @ @ @ @ @ @ @ . @ @ @ @ @ @ @ @ @ @ . @ @ @ @ @ @ @ @ @ @ . @ @ @ @ @ @ @ @ @ @ . @ @ @ @ @ @ @ @ @ @ . @ @ @ @ @ @ @ @ @ @ . @ @ @ @ @ @ @ @ @ @ . @ @ @ @ @ @ @ @ @ @ . @ @ @ @ @ @ @ @ @ @ . @ @ @ @ @ @ @ @ @ @ . . . . . . . . . . . . . . . . . . . . . . . . . @ 
@ . . . . . . . . . . . . . . . . . . . . . . . . . @ @ @ @ @ @ @ @ @ @ . @ @ @ @ @ @ @ @ @ @ . @ @ @ @ @ @ @ @ @ @ . @ @ @ @ @ @ @ @ @ @ . @ @ @ @ @ @ @ @ @ @ . @ @ @ @ @ @ @ @ @ @ . @ @ @ @ @ @ @ @ @ @ . @ @ @ @ @ @ @ @ @ @ . @ @ @ @ @ @ @ @ @ @ . @ @ @ @ @ @ @ @ @ @ . . . . . . . . . . . . . . . . . . . . . . . . . @ 
@ . . . . . . . . . . . . . . . . . . . . . . . . . . . . . . . . . . . . . . . . . . . . . . . . . . . . . . . . . . . . . . . . . . . . . . . . . . . . . . . . . . . . . . . . . . . . . . . . . . . . . . . . . . . . . . . . . . . . . . . . . . . . . . . . . . . . . . . . . . . . . . . . . . . . . . . . . . . . . . . @ 
@ . . . . . . . . . . . . . . . . . . . . . . . . . @ @ @ @ @ @ @ @ @ @ . @ @ @ @ @ @ @ @ @ @ . @ @ @ @ @ @ @ @ @ @ . @ @ @ @ @ @ @ @ @ @ . @ @ @ @ @ @ @ @ @ @ . @ @ @ @ @ @ @ @ @ @ . @ @ @ @ @ @ @ @ @ @ . @ @ @ @ @ @ @ @ @ @ . @ @ @ @ @ @ @ @ @ @ . @ @ @ @ @ @ @ @ @ @ . . . . . . . . . . . . . . . . . . . . . . . . . @ 
@ . . . . . . . . . . . . . . . . . . . . . . . . . @ @ @ @ @ @ @ @ @ @ . @ @ @ @ @ @ @ @ @ @ . @ @ @ @ @ @ @ @ @ @ . @ @ @ @ @ @ @ @ @ @ . @ @ @ @ @ @ @ @ @ @ . @ @ @ @ @ @ @ @ @ @ . @ @ @ @ @ @ @ @ @ @ . @ @ @ @ @ @ @ @ @ @ . @ @ @ @ @ @ @ @ @ @ . @ @ @ @ @ @ @ @ @ @ . . . . . . . . . . . . . . . . . . . . . . . . . @ 
@ . . . . . . . . . . . . . . . . . . . . . . . . . . . . . . . . . . . . . . . . . . . . . . . . . . . . . . . . . . . . . . . . . . . . . . . . . . . . . . . . . . . . . . . . . . . . . . . . . . . . . . . . . . . . . . . . . . . . . . . . . . . . . . . . . . . . . . . . . . . . . . . . . . . . . . . . . . . . . . . @ 
@ . . . . . . . . . . . . . . . . . . . . . . . . . @ @ @ @ @ @ @ @ @ @ . @ @ @ @ @ @ @ @ @ @ . @ @ @ @ @ @ @ @ @ @ . @ @ @ @ @ @ @ @ @ @ . @ @ @ @ @ @ @ @ @ @ . @ @ @ @ @ @ @ @ @ @ . @ @ @ @ @ @ @ @ @ @ . @ @ @ @ @ @ @ @ @ @ . @ @ @ @ @ @ @ @ @ @ . @ @ @ @ @ @ @ @ @ @ . . . . . . . . . . . . . . . . . . . . . . . . . @ 
@ . . . . . . . . . . . . . . . . . . . . . . . . . @ @ @ @ @ @ @ @ @ @ . @ @ @ @ @ @ @ @ @ @ . @ @ @ @ @ @ @ @ @ @ . @ @ @ @ @ @ @ @ @ @ . @ @ @ @ @ @ @ @ @ @ . @ @ @ @ @ @ @ @ @ @ . @ @ @ @ @ @ @ @ @ @ . @ @ @ @ @ @ @ @ @ @ . @ @ @ @ @ @ @ @ @ @ . @ @ @ @ @ @ @ @ @ @ . . . . . . . . . . . . . . . . . . . . . . . . . @ 
@ . . . . . . . . . . . . . . . . . . . . . . . . . . . . . . . . . . . . . . . . . . . . . . . . . . . . . . . . . . . . . . . . . . . . . . . . . . . . . . . . . . . . . . . . . . . . . . . . . . . . . . . . . . . . . . . . . . . . . . . . . . . . . . . . . . . . . . . . . . . . . . . . . . . . . . . . . . . . . . . @ 
@ . . . . . . . . . . . . . . . . . . . . . . . . . @ @ @ @ @ @ @ @ @ @ . @ @ @ @ @ @ @ @ @ @ . @ @ @ @ @ @ @ @ @ @ . @ @ @ @ @ @ @ @ @ @ . @ @ @ @ @ @ @ @ @ @ . @ @ @ @ @ @ @ @ @ @ . @ @ @ @ @ @ @ @ @ @ . @ @ @ @ @ @ @ @ @ @ . @ @ @ @ @ @ @ @ @ @ . @ @ @ @ @ @ @ @ @ @ . . . . . . . . . . . . . . . . . . . . . . . . . @ 
@ . . . . . . . . . . . . . . . . . . . . . . . . . @ @ @ @ @ @ @ @ @ @ . @ @ @ @ @ @ @ @ @ @ . @ @ @ @ @ @ @ @ @ @ . @ @ @ @ @ @ @ @ @ @ . @ @ @ @ @ @ @ @ @ @ . @ @ @ @ @ @ @ @ @ @ . @ @ @ @ @ @ @ @ @ @ . @ @ @ @ @ @ @ @ @ @ . @ @ @ @ @ @ @ @ @ @ . @ @ @ @ @ @ @ @ @ @ . . . . . . . . . . . . . . . . . . . . . . . . . @ 
@ . . . . . . . . . . . . . . . . . . . . . . . . . . . . . . . . . . . . . . . . . . . . . . . . . . . . . . . . . . . . . . . . . . . . . . . . . . . . . . . . . . . . . . . . . . . . . . . . . . . . . . . . . . . . . . . . . . . . . . . . . . . . . . . . . . . . . . . . . . . . . . . . . . . . . . . . . . . . . . . @ 
@ . . . . . . . . . . . . . . . . . . . . . . . . . @ @ @ @ @ @ @ @ @ @ . @ @ @ @ @ @ @ @ @ @ . @ @ @ @ @ @ @ @ @ @ . @ @ @ @ @ @ @ @ @ @ . @ @ @ @ @ @ @ @ @ @ . @ @ @ @ @ @ @ @ @ @ . @ @ @ @ @ @ @ @ @ @ . @ @ @ @ @ @ @ @ @ @ . @ @ @ @ @ @ @ @ @ @ . @ @ @ @ @ @ @ @ @ @ . . . . . . . . . . . . . . . . . . . . . . . . . @ 
@ . . . . . . . . . . . . . . . . . . . . . . . . . @ @ @ @ @ @ @ @ @ @ . @ @ @ @ @ @ @ @ @ @ . @ @ @ @ @ @ @ @ @ @ . @ @ @ @ @ @ @ @ @ @ . @ @ @ @ @ @ @ @ @ @ . @ @ @ @ @ @ @ @ @ @ . @ @ @ @ @ @ @ @ @ @ . @ @ @ @ @ @ @ @ @ @ . @ @ @ @ @ @ @ @ @ @ . @ @ @ @ @ @ @ @ @ @ . . . . . . . . . . . . . . . . . . . . . . . . . @ 
@ . . . . . . . . . . . . . . . . . . . . . . . . . . . . . . . . . . . . . . . . . . . . . . . . . . . . . . . . . . . . . . . . . . . . . . . . . . . . . . . . . . . . . . . . . . . . . . . . . . . . . . . . . . . . . . . . . . . . . . . . . . . . . . . . . . . . . . . . . . . . . . . . . . . . . . . . . . . . . . . @ 
@ . . . . . . . . . . . . . . . . . . . . . . . . . @ @ @ @ @ @ @ @ @ @ . @ @ @ @ @ @ @ @ @ @ . @ @ @ @ @ @ @ @ @ @ . @ @ @ @ @ @ @ @ @ @ . @ @ @ @ @ @ @ @ @ @ . @ @ @ @ @ @ @ @ @ @ . @ @ @ @ @ @ @ @ @ @ . @ @ @ @ @ @ @ @ @ @ . @ @ @ @ @ @ @ @ @ @ . @ @ @ @ @ @ @ @ @ @ . . . . . . . . . . . . . . . . . . . . . . . . . @ 
@ . . . . . . . . . . . . . . . . . . . . . . . . . @ @ @ @ @ @ @ @ @ @ . @ @ @ @ @ @ @ @ @ @ . @ @ @ @ @ @ @ @ @ @ . @ @ @ @ @ @ @ @ @ @ . @ @ @ @ @ @ @ @ @ @ . @ @ @ @ @ @ @ @ @ @ . @ @ @ @ @ @ @ @ @ @ . @ @ @ @ @ @ @ @ @ @ . @ @ @ @ @ @ @ @ @ @ . @ @ @ @ @ @ @ @ @ @ . . . . . . . . . . . . . . . . . . . . . . . . . @ 
@ . . . . . . . . . . . . . . . . . . . . . . . . . . . . . . . . . . . . . . . . . . . . . . . . . . . . . . . . . . . . . . . . . . . . . . . . . . . . . . . . . . . . . . . . . . . . . . . . . . . . . . . . . . . . . . . . . . . . . . . . . . . . . . . . . . . . . . . . . . . . . . . . . . . . . . . . . . . . . . . @ 
@ . . . . . . . . . . . . . . . . . . . . . . . . . @ @ @ @ @ @ @ @ @ @ . @ @ @ @ @ @ @ @ @ @ . @ @ @ @ @ @ @ @ @ @ . @ @ @ @ @ @ @ @ @ @ . @ @ @ @ @ @ @ @ @ @ . @ @ @ @ @ @ @ @ @ @ . @ @ @ @ @ @ @ @ @ @ . @ @ @ @ @ @ @ @ @ @ . @ @ @ @ @ @ @ @ @ @ . @ @ @ @ @ @ @ @ @ @ . . . . . . . . . . . . . . . . . . . . . . . . . @ 
@ . . . . . . . . . . . . . . . . . . . . . . . . . @ @ @ @ @ @ @ @ @ @ . @ @ @ @ @ @ @ @ @ @ . @ @ @ @ @ @ @ @ @ @ . @ @ @ @ @ @ @ @ @ @ . @ @ @ @ @ @ @ @ @ @ . @ @ @ @ @ @ @ @ @ @ . @ @ @ @ @ @ @ @ @ @ . @ @ @ @ @ @ @ @ @ @ . @ @ @ @ @ @ @ @ @ @ . @ @ @ @ @ @ @ @ @ @ . . . . . . . . . . . . . . . . . . . . . . . . . @ 
@ . . . . . . . . . . . . . . . . . . . . . . . . . . . . . . . . . . . . . . . . . . . . . . . . . . . . . . . . . . . . . . . . . . . . . . . . . . . . . . . . . . . . . . . . . . . . . . . . . . . . . . . . . . . . . . . . . . . . . . . . . . . . . . . . . . . . . . . . . . . . . . . . . . . . . . . . . . . . . . . @ 
@ . . . . . . . . . . . . . . . . . . . . . . . . . @ @ @ @ @ @ @ @ @ @ . @ @ @ @ @ @ @ @ @ @ . @ @ @ @ @ @ @ @ @ @ . @ @ @ @ @ @ @ @ @ @ . @ @ @ @ @ @ @ @ @ @ . @ @ @ @ @ @ @ @ @ @ . @ @ @ @ @ @ @ @ @ @ . @ @ @ @ @ @ @ @ @ @ . @ @ @ @ @ @ @ @ @ @ . @ @ @ @ @ @ @ @ @ @ . . . . . . . . . . . . . . . . . . . . . . . . . @ 
@ . . . . . . . . . . . . . . . . . . . . . . . . . @ @ @ @ @ @ @ @ @ @ . @ @ @ @ @ @ @ @ @ @ . @ @ @ @ @ @ @ @ @ @ . @ @ @ @ @ @ @ @ @ @ . @ @ @ @ @ @ @ @ @ @ . @ @ @ @ @ @ @ @ @ @ . @ @ @ @ @ @ @ @ @ @ . @ @ @ @ @ @ @ @ @ @ . @ @ @ @ @ @ @ @ @ @ . @ @ @ @ @ @ @ @ @ @ . . . . . . . . . . . . . . . . . . . . . . . . . @ 
@ . . . . . . . . . . . . . . . . . . . . . . . . . . . . . . . . . . . . . . . . . . . . . . . . . . . . . . . . . . . . . . . . . . . . . . . . . . . . . . . . . . . . . . . . . . . . . . . . . . . . . . . . . . . . . . . . . . . . . . . . . . . . . . . . . . . . . . . . . . . . . . . . . . . . . . . . . . . . . . . @ 
@ . . . . . . . . . . . . . . . . . . . . . . . . . @ @ @ @ @ @ @ @ @ @ . @ @ @ @ @ @ @ @ @ @ . @ @ @ @ @ @ @ @ @ @ . @ @ @ @ @ @ @ @ @ @ . @ @ @ @ @ @ @ @ @ @ . @ @ @ @ @ @ @ @ @ @ . @ @ @ @ @ @ @ @ @ @ . @ @ @ @ @ @ @ @ @ @ . @ @ @ @ @ @ @ @ @ @ . @ @ @ @ @ @ @ @ @ @ . . . . . . . . . . . . . . . . . . . . . . . . . @ 
@ . . . . . . . . . . . . . . . . . . . . . . . . . @ @ @ @ @ @ @ @ @ @ . @ @ @ @ @ @ @ @ @ @ . @ @ @ @ @ @ @ @ @ @ . @ @ @ @ @ @ @ @ @ @ . @ @ @ @ @ @ @ @ @ @ . @ @ @ @ @ @ @ @ @ @ . @ @ @ @ @ @ @ @ @ @ . @ @ @ @ @ @ @ @ @ @ . @ @ @ @ @ @ @ @ @ @ . @ @ @ @ @ @ @ @ @ @ . . . . . . . . . . . . . . . . . . . . . . . . . @ 
@ . . . . . . . . . . . . . . . . . . . . . . . . . . . . . . . . . . . . . . . . . . . . . . . . . . . . . . . . . . . . . . . . . . . . . . . . . . . . . . . . . . . . . . . . . . . . . . . . . . . . . . . . . . . . . . . . . . . . . . . . . . . . . . . . . . . . . . . . . . . . . . . . . . . . . . . . . . . . . . . @ 
@ . . . . . . . . . . . . . . . . . . . . . . . . . @ @ @ @ @ @ @ @ @ @ . @ @ @ @ @ @ @ @ @ @ . @ @ @ @ @ @ @ @ @ @ . @ @ @ @ @ @ @ @ @ @ . @ @ @ @ @ @ @ @ @ @ . @ @ @ @ @ @ @ @ @ @ . @ @ @ @ @ @ @ @ @ @ . @ @ @ @ @ @ @ @ @ @ . @ @ @ @ @ @ @ @ @ @ . @ @ @ @ @ @ @ @ @ @ . . . . . . . . . . . . . . . . . . . . . . . . . @ 
@ . . . . . . . . . . . . . . . . . . . . . . . . . @ @ @ @ @ @ @ @ @ @ . @ @ @ @ @ @ @ @ @ @ . @ @ @ @ @ @ @ @ @ @ . @ @ @ @ @ @ @ @ @ @ . @ @ @ @ @ @ @ @ @ @ . @ @ @ @ @ @ @ @ @ @ . @ @ @ @ @ @ @ @ @ @ . @ @ @ @ @ @ @ @ @ @ . @ @ @ @ @ @ @ @ @ @ . @ @ @ @ @ @ @ @ @ @ . . . . . . . . . . . . . . . . . . . . . . . . . @ 
@ . . . . . . . . . . . . . . . . . . . . . . . . . . . . . . . . . . . . . . . . . . . . . . . . . . . . . . . . . . . . . . . . . . . . . . . . . . . . . . . . . . . . . . . . . . . . . . . . . . . . . . . . . . . . . . . . . . . . . . . . . . . . . . . . . . . . . . . . . . . . . . . . . . . . . . . . . . . . . . . @ 
@ . . . . . . . . . . . . . . . . . . . . . . . . . @ @ @ @ @ @ @ @ @ @ . @ @ @ @ @ @ @ @ @ @ . @ @ @ @ @ @ @ @ @ @ . @ @ @ @ @ @ @ @ @ @ . @ @ @ @ @ @ @ @ @ @ . @ @ @ @ @ @ @ @ @ @ . @ @ @ @ @ @ @ @ @ @ . @ @ @ @ @ @ @ @ @ @ . @ @ @ @ @ @ @ @ @ @ . @ @ @ @ @ @ @ @ @ @ . . . . . . . . . . . . . . . . . . . . . . . . . @ 
@ . . . . . . . . . . . . . . . . . . . . . . . . . @ @ @ @ @ @ @ @ @ @ . @ @ @ @ @ @ @ @ @ @ . @ @ @ @ @ @ @ @ @ @ . @ @ @ @ @ @ @ @ @ @ . @ @ @ @ @ @ @ @ @ @ . @ @ @ @ @ @ @ @ @ @ . @ @ @ @ @ @ @ @ @ @ . @ @ @ @ @ @ @ @ @ @ . @ @ @ @ @ @ @ @ @ @ . @ @ @ @ @ @ @ @ @ @ . . . . . . . . . . . . . . . . . . . . . . . . . @ 
@ . . . . . . . . . . . . . . . . . . . . . . . . . . . . . . . . . . . . . . . . . . . . . . . . . . . . . . . . . . . . . . . . . . . . . . . . . . . . . . . . . . . . . . . . . . . . . . . . . . . . . . . . . . . . . . . . . . . . . . . . . . . . . . . . . . . . . . . . . . . . . . . . . . . . . . . . . . . . . . . @ 
@ . . . . . . . . . . . . . . . . . . . . . . . . . @ @ @ @ @ @ @ @ @ @ . @ @ @ @ @ @ @ @ @ @ . @ @ @ @ @ @ @ @ @ @ . @ @ @ @ @ @ @ @ @ @ . @ @ @ @ @ @ @ @ @ @ . @ @ @ @ @ @ @ @ @ @ . @ @ @ @ @ @ @ @ @ @ . @ @ @ @ @ @ @ @ @ @ . @ @ @ @ @ @ @ @ @ @ . @ @ @ @ @ @ @ @ @ @ . . . . . . . . . . . . . . . . . . . . . . . . . @ 
@ . . . . . . . . . . . . . . . . . . . . . . . . . @ @ @ @ @ @ @ @ @ @ . @ @ @ @ @ @ @ @ @ @ . @ @ @ @ @ @ @ @ @ @ . @ @ @ @ @ @ @ @ @ @ . @ @ @ @ @ @ @ @ @ @ . @ @ @ @ @ @ @ @ @ @ . @ @ @ @ @ @ @ @ @ @ . @ @ @ @ @ @ @ @ @ @ . @ @ @ @ @ @ @ @ @ @ . @ @ @ @ @ @ @ @ @ @ . . . . . . . . . . . . . . . . . . . . . . . . . @ 
@ . . . . . . . . . . . . . . . . . . . . . . . . . . . . . . . . . . . . . . . . . . . . . . . . . . . . . . . . . . . . . . . . . . . . . . . . . . . . . . . . . . . . . . . . . . . . . . . . . . . . . . . . . . . . . . . . . . . . . . . . . . . . . . . . . . . . . . . . . . . . . . . . . . . . . . . . . . . . . . . @ 
@ . . . . . . . . . . . . . . . . . . . . . . . . . @ @ @ @ @ @ @ @ @ @ . @ @ @ @ @ @ @ @ @ @ . @ @ @ @ @ @ @ @ @ @ . @ @ @ @ @ @ @ @ @ @ . @ @ @ @ @ @ @ @ @ @ . @ @ @ @ @ @ @ @ @ @ . @ @ @ @ @ @ @ @ @ @ . @ @ @ @ @ @ @ @ @ @ . @ @ @ @ @ @ @ @ @ @ . @ @ @ @ @ @ @ @ @ @ . . . . . . . . . . . . . . . . . . . . . . . . . @ 
@ . . . . . . . . . . . . . . . . . . . . . . . . . @ @ @ @ @ @ @ @ @ @ . @ @ @ @ @ @ @ @ @ @ . @ @ @ @ @ @ @ @ @ @ . @ @ @ @ @ @ @ @ @ @ . @ @ @ @ @ @ @ @ @ @ . @ @ @ @ @ @ @ @ @ @ . @ @ @ @ @ @ @ @ @ @ . @ @ @ @ @ @ @ @ @ @ . @ @ @ @ @ @ @ @ @ @ . @ @ @ @ @ @ @ @ @ @ . . . . . . . . . . . . . . . . . . . . . . . . . @ 
@ . . . . . . . . . . . . . . . . . . . . . . . . . . . . . . . . . . . . . . . . . . . . . . . . . . . . . . . . . . . . . . . . . . . . . . . . . . . . . . . . . . . . . . . . . . . . . . . . . . . . . . . . . . . . . . . . . . . . . . . . . . . . . . . . . . . . . . . . . . . . . . . . . . . . . . . . . . . . . . . @ 
@ . . . . . . . . . . . . . . . . . . . . . . . . . @ @ @ @ @ @ @ @ @ @ . @ @ @ @ @ @ @ @ @ @ . @ @ @ @ @ @ @ @ @ @ . @ @ @ @ @ @ @ @ @ @ . @ @ @ @ @ @ @ @ @ @ . @ @ @ @ @ @ @ @ @ @ . @ @ @ @ @ @ @ @ @ @ . @ @ @ @ @ @ @ @ @ @ . @ @ @ @ @ @ @ @ @ @ . @ @ @ @ @ @ @ @ @ @ . . . . . . . . . . . . . . . . . . . . . . . . . @ 
@ . . . . . . . . . . . . . . . . . . . . . . . . . @ @ @ @ @ @ @ @ @ @ . @ @ @ @ @ @ @ @ @ @ . @ @ @ @ @ @ @ @ @ @ . @ @ @ @ @ @ @ @ @ @ . @ @ @ @ @ @ @ @ @ @ . @ @ @ @ @ @ @ @ @ @ . @ @ @ @ @ @ @ @ @ @ . @ @ @ @ @ @ @ @ @ @ . @ @ @ @ @ @ @ @ @ @ . @ @ @ @ @ @ @ @ @ @ . . . . . . . . . . . . . . . . . . . . . . . . . @ 
@ . . . . . . . . . . . . . . . . . . . . . . . . . . . . . . . . . . . . . . . . . . . . . . . . . . . . . . . . . . . . . . . . . . . . . . . . . . . . . . . . . . . . . . . . . . . . . . . . . . . . . . . . . . . . . . . . . . . . . . . . . . . . . . . . . . . . . . . . . . . . . . . . . . . . . . . . . . . . . . . @ 
@ . . . . . . . . . . . . . . . . . . . . . . . . . @ @ @ @ @ @ @ @ @ @ . @ @ @ @ @ @ @ @ @ @ . @ @ @ @ @ @ @ @ @ @ . @ @ @ @ @ @ @ @ @ @ . @ @ @ @ @ @ @ @ @ @ . @ @ @ @ @ @ @ @ @ @ . @ @ @ @ @ @ @ @ @ @ . @ @ @ @ @ @ @ @ @ @ . @ @ @ @ @ @ @ @ @ @ . @ @ @ @ @ @ @ @ @ @ . . . . . . . . . . . . . . . . . . . . . . . . . @ 
@ . . . . . . . . . . . . . . . . . . . . . . . . . @ @ @ @ @ @ @ @ @ @ . @ @ @ @ @ @ @ @ @ @ . @ @ @ @ @ @ @ @ @ @ . @ @ @ @ @ @ @ @ @ @ . @ @ @ @ @ @ @ @ @ @ . @ @ @ @ @ @ @ @ @ @ . @ @ @ @ @ @ @ @ @ @ . @ @ @ @ @ @ @ @ @ @ . @ @ @ @ @ @ @ @ @ @ . @ @ @ @ @ @ @ @ @ @ . . . . . . . . . . . . . . . . . . . . . . . . . @ 
@ . . . . . . . . . . . . . . . . . . . . . . . . . . . . . . . . . . . . . . . . . . . . . . . . . . . . . . . . . . . . . . . . . . . . . . . . . . . . . . . . . . . . . . . . . . . . . . . . . . . . . . . . . . . . . . . . . . . . . . . . . . . . . . . . . . . . . . . . . . . . . . . . . . . . . . . . . . . . . . . @ 
@ . . . . . . . . . . . . . . . . . . . . . . . . . @ @ @ @ @ @ @ @ @ @ . @ @ @ @ @ @ @ @ @ @ . @ @ @ @ @ @ @ @ @ @ . @ @ @ @ @ @ @ @ @ @ . @ @ @ @ @ @ @ @ @ @ . @ @ @ @ @ @ @ @ @ @ . @ @ @ @ @ @ @ @ @ @ . @ @ @ @ @ @ @ @ @ @ . @ @ @ @ @ @ @ @ @ @ . @ @ @ @ @ @ @ @ @ @ . . . . . . . . . . . . . . . . . . . . . . . . . @ 
@ . . . . . . . . . . . . . . . . . . . . . . . . . @ @ @ @ @ @ @ @ @ @ . @ @ @ @ @ @ @ @ @ @ . @ @ @ @ @ @ @ @ @ @ . @ @ @ @ @ @ @ @ @ @ . @ @ @ @ @ @ @ @ @ @ . @ @ @ @ @ @ @ @ @ @ . @ @ @ @ @ @ @ @ @ @ . @ @ @ @ @ @ @ @ @ @ . @ @ @ @ @ @ @ @ @ @ . @ @ @ @ @ @ @ @ @ @ . . . . . . . . . . . . . . . . . . . . . . . . . @ 
@ . . . . . . . . . . . . . . . . . . . . . . . . . . . . . . . . . . . . . . . . . . . . . . . . . . . . . . . . . . . . . . . . . . . . . . . . . . . . . . . . . . . . . . . . . . . . . . . . . . . . . . . . . . . . . . . . . . . . . . . . . . . . . . . . . . . . . . . . . . . . . . . . . . . . . . . . . . . . . . . @ 
@ . . . . . . . . . . . . . . . . . . . . . . . . . @ @ @ @ @ @ @ @ @ @ . @ @ @ @ @ @ @ @ @ @ . @ @ @ @ @ @ @ @ @ @ . @ @ @ @ @ @ @ @ @ @ . @ @ @ @ @ @ @ @ @ @ . @ @ @ @ @ @ @ @ @ @ . @ @ @ @ @ @ @ @ @ @ . @ @ @ @ @ @ @ @ @ @ . @ @ @ @ @ @ @ @ @ @ . @ @ @ @ @ @ @ @ @ @ . . . . . . . . . . . . . . . . . . . . . . . . . @ 
@ . . . . . . . . . . . . . . . . . . . . . . . . . @ @ @ @ @ @ @ @ @ @ . @ @ @ @ @ @ @ @ @ @ . @ @ @ @ @ @ @ @ @ @ . @ @ @ @ @ @ @ @ @ @ . @ @ @ @ @ @ @ @ @ @ . @ @ @ @ @ @ @ @ @ @ . @ @ @ @ @ @ @ @ @ @ . @ @ @ @ @ @ @ @ @ @ . @ @ @ @ @ @ @ @ @ @ . @ @ @ @ @ @ @ @ @ @ . . . . . . . . . . . . . . . . . . . . . . . . . @ 
@ . . . . . . . . . . . . . . . . . . . . . . . . . . . . . . . . . . . . . . . . . . . . . . . . . . . . . . . . . . . . . . . . . . . . . . . . . . . . . . . . . . . . . . . . . . . . . . . . . . . . . . . . . . . . . . . . . . . . . . . . . . . . . . . . . . . . . . . . . . . . . . . . . . . . . . . . . . . . . . . @ 
@ . . . . . . . . . . . . . . . . . . . . . . . . . @ @ @ @ @ @ @ @ @ @ . @ @ @ @ @ @ @ @ @ @ . @ @ @ @ @ @ @ @ @ @ . @ @ @ @ @ @ @ @ @ @ . @ @ @ @ @ @ @ @ @ @ . @ @ @ @ @ @ @ @ @ @ . @ @ @ @ @ @ @ @ @ @ . @ @ @ @ @ @ @ @ @ @ . @ @ @ @ @ @ @ @ @ @ . @ @ @ @ @ @ @ @ @ @ . . . . . . . . . . . . . . . . . . . . . . . . . @ 
@ . . . . . . . . . . . . . . . . . . . . . . . . . @ @ @ @ @ @ @ @ @ @ . @ @ @ @ @ @ @ @ @ @ . @ @ @ @ @ @ @ @ @ @ . @ @ @ @ @ @ @ @ @ @ . @ @ @ @ @ @ @ @ @ @ . @ @ @ @ @ @ @ @ @ @ . @ @ @ @ @ @ @ @ @ @ . @ @ @ @ @ @ @ @ @ @ . @ @ @ @ @ @ @ @ @ @ . @ @ @ @ @ @ @ @ @ @ . . . . . . . . . . . . . . . . . . . . . . . . . @ 
@ . . . . . . . . . . . . . . . . . . . . . . . . . . . . . . . . . . . . . . . . . . . . . . . . . . . . . . . . . . . . . . . . . . . . . . . . . . . . . . . . . . . . . . . . . . . . . . . . . . . . . . . . . . . . . . . . . . . . . . . . . . . . . . . . . . . . . . . . . . . . . . . . . . . . . . . . . . . . . . . @ 
@ @ @ @ @ @ @ @ @ @ @ @ @ @ @ @ @ @ @ @ @ @ @ @ @ @ @ @ @ @ @ @ @ @ @ @ @ @ @ @ @ @ @ @ @ @ @ @ @ @ @ @ @ @ @ @ @ @ @ @ @ @ @ @ @ @ @ @ @ @ @ @ @ @ @ @ @ @ @ @ @ @ @ @ @ @ @ @ @ @ @ @ @ @ @ @ @ @ @ @ @ @ @ @ @ @ @ @ @ @ @ @ @ @ @ @ @ @ @ @ @ @ @ @ @ @ @ @ @ @ @ @ @ @ @ @ @ @ @ @ @ @ @ @ @ @ @ @ @ @ @ @ @ @ @ @ @ @ @ @ @ 
300 
42 16 26 154 
10 57 10 53 
49 134 7 39 
7 153 55 14 
40 37 5 154 
16 26 38 24 
46 16 30 113 
61 137 32 15 
55 131 41 147 
17 136 60 7 
43 136 60 155 
24 9 41 157 
46 77 36 91 
43 107 20 16 
58 115 52 135 
61 127 58 12 
49 103 14 3 
10 107 41 144 
60 3 7 21 
19 5 56 146 
58 106 43 105 
19 43 35 11 
7 73 27 19 
15 69 43 91 
13 94 4 130 
19 130 5 15 
36 145 53 102 
31 64 49 133 
15 14 20 150 
56 58 44 102 
23 113 16 9 
45 69 31 21 
13 46 5 145 
19 61 61 118 
40 43 28 60 
21 142 26 2 
7 156 47 157 
45 4 40 36 
14 139 2 153 
53 6 1 79 
22 131 4 123 
37 22 25 13 
53 1 7 146 
9 156 23 149 
44 156 55 69 
30 19 43 34 
19 19 48 1 
1 122 43 116 
5 8 5 80 
1 30 43 151 
40 14 31 78 
53 149 58 74 
43 149 29 18 
7 54 19 115 
9 151 51 69 
19 118 31 108 
37 110 14 142 
42 159 57 14 
58 149 5 102 
61 109 34 120 
40 154 21 152 
10 89 46 61 
26 7 55 138 
52 120 60 14 
17 69 22 82 
48 147 37 85 
28 132 26 14 
20 12 10 33 
57 141 49 12 
49 45 14 113 
25 54 55 12 
52 49 22 67 
47 156 52 137 
28 2 60 153 
28 106 1 124 
15 150 16 92 
4 80 23 124 
11 69 22 55 
10 126 34 151 
19 71 27 140 
24 12 28 117 
13 50 29 143 
12 3 40 46 
26 157 24 16 
46 90 40 91 
20 7 20 58 
8 152 3 152 
25 48 7 65 
17 18 1 61 
4 118 10 134 
37 82 52 107 
61 3 1 72 
52 83 25 150 
7 133 17 113 
51 136 49 124 
33 21 6 146 
57 8 7 116 
52 39 33 136 
3 20 43 31 
8 24 3 18 
29 154 31 102 
43 153 24 5 
17 14 46 60 
32 14 60 23 
6 135 16 63 
59 157 53 148 
40 54 12 151 
49 3 54 47 
13 44 31 100 
30 102 52 148 
17 140 52 61 
7 70 24 69 
6 9 48 3 
50 23 36 113 
49 116 16 155 
61 115 39 137 
61 83 37 99 
46 47 58 121 
4 95 52 94 
26 155 37 17 
20 17 7 88 
56 16 22 95 
22 115 45 149 
60 141 36 151 
27 147 1 16 
13 146 14 138 
19 35 27 102 
34 115 13 63 
26 142 23 154 
7 96 31 156 
25 28 6 10 
10 100 22 136 
58 130 4 141 
1 34 4 37 
23 20 55 6 
22 52 6 149 
7 92 7 142 
61 77 38 142 
45 10 53 36 
47 137 57 1 
4 13 31 16 
49 78 21 1 
34 11 34 123 
61 38 61 132 
2 9 31 124 
7 131 56 22 
44 3 30 3 
25 109 35 158 
40 73 16 59 
37 2 46 73 
3 157 22 119 
34 141 28 84 
56 36 11 25 
9 25 34 42 
7 46 14 19 
41 143 27 13 
28 15 31 126 
10 31 32 18 
61 112 16 24 
46 130 58 38 
52 111 13 37 
4 131 25 106 
61 63 49 32 
1 18 22 114 
30 15 11 12 
1 148 35 2 
13 154 28 156 
11 13 55 89 
40 1 7 124 
55 99 2 158 
21 69 39 36 
22 42 28 115 
49 30 42 102 
12 102 27 22 
54 158 61 50 
50 22 55 144 
22 65 19 62 
58 67 55 16 
7 158 59 146 
33 147 61 124 
4 12 28 119 
22 9 46 105 
37 108 22 5 
53 7 24 23 
22 27 14 137 
33 137 14 47 
32 136 50 141 
31 93 50 24 
54 136 37 100 
27 25 60 157 
1 71 25 116 
60 8 47 139 
54 2 1 129 
61 143 34 75 
4 105 61 136 
1 135 17 3 
49 104 23 80 
15 124 4 8 
7 141 7 105 
58 72 16 107 
21 147 39 13 
44 141 35 19 
20 143 38 4 
1 136 4 133 
59 136 10 96 
59 113 6 13 
51 19 30 91 
46 118 19 103 
21 80 49 157 
31 96 16 149 
46 126 52 5 
61 44 44 142 
28 77 49 136 
16 58 19 76 
49 59 31 25 
10 138 34 72 
35 47 61 69 
61 140 17 47 
47 15 56 12 
16 150 31 17 
21 11 11 139 
56 21 54 23 
32 149 58 92 
15 5 12 1 
26 3 52 46 
28 71 11 144 
28 95 26 25 
49 112 40 147 
47 102 52 24 
8 153 15 140 
37 157 44 150 
8 16 58 156 
16 61 25 70 
46 109 25 158 
23 36 4 138 
25 108 43 125 
25 51 10 139 
22 64 16 37 
31 107 31 68 
37 154 49 90 
28 98 31 18 
27 5 6 3 
61 27 39 4 
14 58 22 112 
25 130 10 145 
51 154 61 10 
23 136 34 16 
45 58 52 20 
1 154 6 2 
4 103 23 11 
34 128 40 118 
40 39 39 143 
53 8 13 139 
31 116 47 7 
49 64 60 146 
47 138 12 138 
9 21 52 134 
13 114 3 25 
30 150 40 159 
49 41 7 84 
14 14 52 117 
54 159 37 53 
6 19 43 129 
55 37 32 11 
22 41 34 37 
58 20 43 97 
43 120 34 102 
49 53 51 7 
28 87 54 149 
33 19 41 158 
1 97 45 7 
15 144 13 55 
52 8 32 113 
61 153 56 19 
4 62 8 159 
28 14 58 109 
28 37 12 13 
16 120 58 21 
28 92 8 138 
43 2 25 52 
48 20 22 129 
43 18 9 147 
61 107 37 14 
42 158 58 33 
30 1 37 136 
3 137 1 2 
4 35 41 24 
9 159 42 2 
28 130 39 153 
7 33 47 12 
32 156 12 147 
15 25 49 57 
32 19 43 81 
48 22 11 58 
61 54 22 2 
29 91 43 145 
55 103 43 42 
16 133 49 99 
13 51 12 6 
37 46 34 5 
