32 32 
.......@.........@@.......@.....
.....................@...@.....@
.......@@......@..@@......@.....
...............@.............@..
@..............@........@.......
.........@..........@.@.........
@...@.@.........................
........@..............@@.......
..@...@.....@.@@...@......@.....
........@...@.............@.....
.................@..............
.......@@....@......@..........@
@....@.@...@.@.............@...@
@........@.@..................@.
....@..@@.......................
........@......@....@...........
@.................@............@
............................@...
@@....@........@.@..............
...@......................@.@...
....@...........................
....@.........................@@
@.............@.......@..@......
....................@..@.@..@...
.....@@..............@..........
................................
.@............@......@......@..@
.......@........................
...@.................@@.........
.........@............@.........
....@..........@................
...@...................@........
50 
24 0 28 9 
25 8 14 26 
23 10 4 23 
10 8 30 13 
5 19 23 27 
10 2 29 6 
26 7 27 26 
31 8 28 2 
21 23 28 4 
19 23 21 5 
23 17 22 1 
11 14 6 21 
18 25 23 13 
26 11 24 1 
24 29 28 26 
25 5 23 7 
29 11 12 3 
29 4 25 20 
21 16 12 12 
24 20 30 3 
7 10 21 9 
30 6 28 0 
20 9 22 12 
19 27 30 11 
22 24 3 26 
17 10 24 9 
14 6 13 16 
20 13 7 15 
18 14 30 16 
10 3 8 9 
17 8 19 13 
27 25 6 24 
22 17 14 3 
2 20 13 28 
27 10 25 15 
27 8 9 6 
16 11 18 22 
30 1 11 3 
14 17 5 23 
3 19 1 15 
11 5 15 22 
4 5 10 6 
6 20 24 7 
24 24 26 22 
28 16 13 23 
1 9 8 21 
25 31 3 27 
31 24 23 26 
20 25 19 22 
19 11 2 0 
