32 32 
@@@@@@@@@@@@@@@@@@@@@@@@@@@@@@@@
@..@..@.........................
@..@..@.........................
@..@..@..@@@@@@@@@@@@@..@@@@..@.
@.....@..............@..@..@..@.
@.....@..............@..@..@..@.
@..@@@@@@@..@@@@@@@@@@..@..@@@@.
@...........@...........@.....@.
@...........@...........@.....@.
@@@@@@@@@@@@@..@@@@..@@@@..@@@@@
@..............@.....@..@..@....
@..............@.....@..@..@....
@..@@@@@@@@@@@@@@@@@@@..@..@@@@.
@..............@.....@.....@....
@..............@.....@.....@....
@..@@@@@@@..@@@@..@..@@@@..@..@@
@..@........@.....@........@..@.
@..@........@.....@........@..@.
@@@@..@@@@..@..@@@@..@@@@@@@..@.
@.....@.....@..@.....@........@.
@.....@.....@..@.....@........@.
@..@..@@@@@@@..@..@@@@..@@@@@@@.
@..@........@..@..@..@..@.......
@..@........@..@..@..@..@.......
@..@@@@..@@@@..@@@@..@..@@@@@@@.
@..@..@.................@.......
@..@..@.................@.......
@..@..@@@@@@@@@@..@@@@@@@..@@@@.
@..@..@........@..@........@..@.
@..@..@........@..@........@..@.
@..@..@@@@..@..@..@@@@..@@@@..@.
@.....@.....@...........@.......
40 
14 4 25 9 
6 22 20 24 
21 17 26 22 
21 2 28 5 
31 29 29 8 
20 11 4 28 
9 13 20 28 
13 2 20 26 
5 12 26 5 
28 31 1 17 
8 26 21 14 
14 22 7 29 
26 16 9 25 
4 11 16 20 
4 10 13 20 
23 25 4 23 
3 8 26 17 
11 20 12 26 
4 14 16 28 
31 8 25 19 
30 13 25 2 
26 31 11 7 
11 16 22 28 
25 15 22 8 
29 19 19 7 
8 8 17 15 
2 22 5 23 
19 22 28 24 
16 23 13 29 
11 19 13 25 
20 3 20 19 
14 1 7 16 
17 7 10 26 
7 4 9 26 
17 5 31 26 
28 25 8 14 
1 9 22 4 
16 4 26 28 
24 31 5 19 
14 24 19 19 
