32 32 
.......@.........@@.......@.....
.....................@...@.....@
.......@@......@..@@......@.....
...............@.............@..
@..............@........@.......
.........@..........@.@.........
@...@.@.........................
........@..............@@.......
..@...@.....@.@@...@......@.....
........@...@.............@.....
.................@..............
.......@@....@......@..........@
@....@.@...@.@.............@...@
@........@.@..................@.
....@..@@.......................
........@......@....@...........
@.................@............@
............................@...
@@....@........@.@..............
...@......................@.@...
....@...........................
....@.........................@@
@.............@.......@..@......
....................@..@.@..@...
.....@@..............@..........
................................
.@............@......@......@..@
.......@........................
...@.................@@.........
.........@............@.........
....@..........@................
...@...................@........
55 
9 22 7 21 
20 1 7 14 
30 20 8 30 
22 18 12 20 
27 18 21 29 
16 27 23 26 
21 27 21 7 
10 21 28 28 
23 7 4 28 
2 12 27 17 
20 21 31 11 
12 22 11 10 
8 23 18 16 
24 10 30 5 
28 5 29 29 
11 29 13 31 
23 2 30 17 
10 22 22 1 
5 25 12 1 
24 7 17 11 
28 27 11 26 
19 31 1 8 
15 19 20 29 
23 9 4 23 
10 11 9 30 
30 28 10 12 
9 9 27 30 
4 25 19 30 
14 14 26 30 
4 8 5 2 
5 24 26 15 
11 1 21 5 
28 26 2 28 
9 13 22 29 
5 17 14 22 
9 23 22 7 
15 31 28 6 
26 13 31 27 
0 1 0 22 
6 16 25 29 
18 10 25 13 
5 11 15 7 
29 13 27 5 
20 9 31 15 
6 28 17 7 
24 23 29 30 
20 13 4 13 
24 12 21 14 
12 18 6 17 
7 4 10 0 
5 3 1 9 
26 18 16 8 
10 30 15 14 
19 17 2 5 
17 6 15 9 
