32 32 
.......@.........@@.......@.....
.....................@...@.....@
.......@@......@..@@......@.....
...............@.............@..
@..............@........@.......
.........@..........@.@.........
@...@.@.........................
........@..............@@.......
..@...@.....@.@@...@......@.....
........@...@.............@.....
.................@..............
.......@@....@......@..........@
@....@.@...@.@.............@...@
@........@.@..................@.
....@..@@.......................
........@......@....@...........
@.................@............@
............................@...
@@....@........@.@..............
...@......................@.@...
....@...........................
....@.........................@@
@.............@.......@..@......
....................@..@.@..@...
.....@@..............@..........
................................
.@............@......@......@..@
.......@........................
...@.................@@.........
.........@............@.........
....@..........@................
...@...................@........
20 
13 4 9 31 
29 23 28 23 
18 28 10 26 
29 11 25 16 
3 2 24 26 
25 8 9 18 
11 28 18 11 
4 6 11 21 
15 31 26 25 
30 23 22 26 
5 16 8 27 
7 2 3 0 
23 7 24 23 
27 3 1 8 
25 17 22 9 
3 6 18 4 
7 27 10 3 
4 14 16 17 
25 4 5 2 
7 14 9 10 
