64 64 
@ @ @ . @ @ @ @ @ @ @ @ @ @ @ @ @ @ @ . @ @ @ @ @ @ . @ @ @ @ @ @ @ . @ @ @ @ @ @ @ @ @ @ @ @ @ @ . @ @ @ @ @ @ @ . @ @ @ @ @ @ 
@ . . . . . . . @ . . . . . . . @ . . . . . . . @ . . . . . . . @ . . . . . . . @ . . . . . . . @ . . . . . . . @ . . . . . . . 
@ . . . . . . . @ . . . . . . . @ . . . . . . . @ . . . . . . . @ . . . . . . . @ . . . . . . . @ . . . . . . . @ . . . . . . . 
. . . . . . . . @ . . . . . . . @ . . . . . . . @ . . . . . . . @ . . . . . . . @ . . . . . . . @ . . . . . . . @ . . . . . . . 
@ . . . . . . . @ . . . . . . . @ . . . . . . . @ . . . . . . . @ . . . . . . . @ . . . . . . . @ . . . . . . . @ . . . . . . . 
@ . . . . . . . . . . . . . . . . . . . . . . . @ . . . . . . . @ . . . . . . . @ . . . . . . . @ . . . . . . . . . . . . . . . 
@ . . . . . . . @ . . . . . . . @ . . . . . . . @ . . . . . . . @ . . . . . . . @ . . . . . . . @ . . . . . . . @ . . . . . . . 
@ . . . . . . . @ . . . . . . . @ . . . . . . . . . . . . . . . . . . . . . . . @ . . . . . . . . . . . . . . . @ . . . . . . . 
@ . @ @ @ @ @ @ @ @ @ @ @ . @ @ @ @ @ @ @ . @ @ @ . @ @ @ @ @ @ @ . @ @ @ @ @ @ @ @ @ @ @ @ @ . @ @ @ @ @ @ . @ @ . @ @ @ @ @ @ 
@ . . . . . . . @ . . . . . . . @ . . . . . . . @ . . . . . . . @ . . . . . . . @ . . . . . . . @ . . . . . . . @ . . . . . . . 
@ . . . . . . . @ . . . . . . . @ . . . . . . . . . . . . . . . . . . . . . . . @ . . . . . . . @ . . . . . . . @ . . . . . . . 
@ . . . . . . . @ . . . . . . . @ . . . . . . . @ . . . . . . . @ . . . . . . . @ . . . . . . . @ . . . . . . . @ . . . . . . . 
. . . . . . . . . . . . . . . . @ . . . . . . . @ . . . . . . . @ . . . . . . . @ . . . . . . . . . . . . . . . @ . . . . . . . 
@ . . . . . . . @ . . . . . . . @ . . . . . . . @ . . . . . . . @ . . . . . . . . . . . . . . . @ . . . . . . . @ . . . . . . . 
@ . . . . . . . @ . . . . . . . @ . . . . . . . @ . . . . . . . @ . . . . . . . @ . . . . . . . @ . . . . . . . . . . . . . . . 
@ . . . . . . . @ . . . . . . . @ . . . . . . . @ . . . . . . . @ . . . . . . . @ . . . . . . . @ . . . . . . . @ . . . . . . . 
@ @ @ @ @ @ @ . @ @ @ @ @ . @ @ @ @ @ @ @ @ @ @ @ @ @ @ @ @ . @ @ @ @ @ @ @ @ @ @ @ @ @ @ . @ @ @ @ @ @ @ @ @ . @ @ @ @ @ @ . @ 
@ . . . . . . . @ . . . . . . . @ . . . . . . . @ . . . . . . . @ . . . . . . . @ . . . . . . . @ . . . . . . . @ . . . . . . . 
@ . . . . . . . @ . . . . . . . @ . . . . . . . @ . . . . . . . @ . . . . . . . . . . . . . . . @ . . . . . . . @ . . . . . . . 
@ . . . . . . . @ . . . . . . . @ . . . . . . . @ . . . . . . . @ . . . . . . . @ . . . . . . . @ . . . . . . . @ . . . . . . . 
. . . . . . . . @ . . . . . . . @ . . . . . . . . . . . . . . . @ . . . . . . . @ . . . . . . . . . . . . . . . @ . . . . . . . 
@ . . . . . . . @ . . . . . . . @ . . . . . . . @ . . . . . . . @ . . . . . . . @ . . . . . . . @ . . . . . . . @ . . . . . . . 
@ . . . . . . . . . . . . . . . @ . . . . . . . @ . . . . . . . @ . . . . . . . @ . . . . . . . @ . . . . . . . @ . . . . . . . 
@ . . . . . . . @ . . . . . . . @ . . . . . . . @ . . . . . . . @ . . . . . . . @ . . . . . . . @ . . . . . . . @ . . . . . . . 
@ . @ @ @ @ @ @ @ @ . @ @ @ @ @ @ @ @ @ @ . @ @ @ @ @ @ @ @ . @ @ @ @ @ @ @ . @ @ . @ @ @ @ @ @ @ . @ @ @ @ @ @ @ @ @ @ @ @ @ . 
@ . . . . . . . . . . . . . . . @ . . . . . . . @ . . . . . . . @ . . . . . . . @ . . . . . . . @ . . . . . . . @ . . . . . . . 
@ . . . . . . . @ . . . . . . . @ . . . . . . . @ . . . . . . . @ . . . . . . . @ . . . . . . . @ . . . . . . . @ . . . . . . . 
@ . . . . . . . @ . . . . . . . @ . . . . . . . @ . . . . . . . . . . . . . . . @ . . . . . . . @ . . . . . . . @ . . . . . . . 
@ . . . . . . . @ . . . . . . . @ . . . . . . . @ . . . . . . . @ . . . . . . . @ . . . . . . . @ . . . . . . . @ . . . . . . . 
. . . . . . . . @ . . . . . . . @ . . . . . . . @ . . . . . . . @ . . . . . . . @ . . . . . . . @ . . . . . . . @ . . . . . . . 
@ . . . . . . . @ . . . . . . . @ . . . . . . . @ . . . . . . . @ . . . . . . . @ . . . . . . . @ . . . . . . . . . . . . . . . 
@ . . . . . . . @ . . . . . . . @ . . . . . . . . . . . . . . . @ . . . . . . . @ . . . . . . . @ . . . . . . . @ . . . . . . . 
@ @ @ @ @ @ @ @ @ @ @ @ @ @ @ @ @ @ . @ @ @ @ @ @ @ @ . @ @ @ @ @ @ @ @ @ @ @ @ @ @ @ @ @ @ @ @ @ @ @ @ @ @ @ . @ @ . @ @ @ @ @ 
@ . . . . . . . @ . . . . . . . @ . . . . . . . @ . . . . . . . @ . . . . . . . @ . . . . . . . @ . . . . . . . @ . . . . . . . 
@ . . . . . . . @ . . . . . . . @ . . . . . . . @ . . . . . . . . . . . . . . . @ . . . . . . . @ . . . . . . . @ . . . . . . . 
@ . . . . . . . @ . . . . . . . @ . . . . . . . @ . . . . . . . @ . . . . . . . @ . . . . . . . @ . . . . . . . @ . . . . . . . 
@ . . . . . . . . . . . . . . . @ . . . . . . . . . . . . . . . @ . . . . . . . @ . . . . . . . @ . . . . . . . @ . . . . . . . 
@ . . . . . . . @ . . . . . . . @ . . . . . . . @ . . . . . . . @ . . . . . . . @ . . . . . . . @ . . . . . . . . . . . . . . . 
. . . . . . . . @ . . . . . . . @ . . . . . . . @ . . . . . . . @ . . . . . . . . . . . . . . . @ . . . . . . . @ . . . . . . . 
@ . . . . . . . @ . . . . . . . @ . . . . . . . @ . . . . . . . @ . . . . . . . @ . . . . . . . @ . . . . . . . @ . . . . . . . 
@ @ @ @ @ @ @ . @ @ @ @ @ @ @ @ @ @ @ @ @ @ @ @ @ @ @ . @ @ @ @ @ @ . @ @ @ @ @ @ @ @ @ @ @ . @ @ @ @ @ . @ @ @ @ @ @ @ . @ @ @ 
@ . . . . . . . @ . . . . . . . @ . . . . . . . @ . . . . . . . @ . . . . . . . @ . . . . . . . . . . . . . . . @ . . . . . . . 
@ . . . . . . . @ . . . . . . . @ . . . . . . . . . . . . . . . . . . . . . . . @ . . . . . . . @ . . . . . . . @ . . . . . . . 
@ . . . . . . . @ . . . . . . . . . . . . . . . @ . . . . . . . @ . . . . . . . @ . . . . . . . @ . . . . . . . @ . . . . . . . 
@ . . . . . . . @ . . . . . . . @ . . . . . . . @ . . . . . . . @ . . . . . . . @ . . . . . . . @ . . . . . . . @ . . . . . . . 
@ . . . . . . . @ . . . . . . . @ . . . . . . . @ . . . . . . . @ . . . . . . . @ . . . . . . . @ . . . . . . . @ . . . . . . . 
@ . . . . . . . . . . . . . . . @ . . . . . . . @ . . . . . . . @ . . . . . . . @ . . . . . . . @ . . . . . . . @ . . . . . . . 
. . . . . . . . @ . . . . . . . @ . . . . . . . @ . . . . . . . @ . . . . . . . @ . . . . . . . @ . . . . . . . @ . . . . . . . 
@ @ @ @ . @ @ @ @ . @ @ @ @ @ @ @ @ . @ @ @ @ @ @ @ @ @ @ @ . @ @ @ @ @ @ @ @ @ @ @ @ @ @ @ . @ @ @ @ @ @ @ @ @ @ @ @ @ @ @ @ @ 
. . . . . . . . @ . . . . . . . @ . . . . . . . @ . . . . . . . @ . . . . . . . @ . . . . . . . @ . . . . . . . @ . . . . . . . 
@ . . . . . . . @ . . . . . . . @ . . . . . . . @ . . . . . . . @ . . . . . . . @ . . . . . . . @ . . . . . . . @ . . . . . . . 
@ . . . . . . . @ . . . . . . . @ . . . . . . . @ . . . . . . . @ . . . . . . . @ . . . . . . . @ . . . . . . . @ . . . . . . . 
@ . . . . . . . @ . . . . . . . @ . . . . . . . @ . . . . . . . @ . . . . . . . @ . . . . . . . @ . . . . . . . . . . . . . . . 
@ . . . . . . . @ . . . . . . . @ . . . . . . . @ . . . . . . . @ . . . . . . . @ . . . . . . . @ . . . . . . . @ . . . . . . . 
@ . . . . . . . @ . . . . . . . @ . . . . . . . @ . . . . . . . @ . . . . . . . @ . . . . . . . @ . . . . . . . @ . . . . . . . 
@ . . . . . . . @ . . . . . . . . . . . . . . . . . . . . . . . . . . . . . . . . . . . . . . . @ . . . . . . . @ . . . . . . . 
@ @ @ @ @ @ @ @ @ @ @ . @ @ @ @ @ @ @ @ @ @ @ @ @ @ @ @ @ @ @ . @ @ @ @ @ @ @ @ @ @ @ @ @ . @ @ @ @ @ @ @ @ @ . @ @ @ @ @ @ @ @ 
@ . . . . . . . @ . . . . . . . @ . . . . . . . @ . . . . . . . @ . . . . . . . @ . . . . . . . @ . . . . . . . @ . . . . . . . 
@ . . . . . . . . . . . . . . . . . . . . . . . @ . . . . . . . @ . . . . . . . @ . . . . . . . @ . . . . . . . @ . . . . . . . 
@ . . . . . . . @ . . . . . . . @ . . . . . . . . . . . . . . . @ . . . . . . . @ . . . . . . . . . . . . . . . . . . . . . . . 
@ . . . . . . . @ . . . . . . . @ . . . . . . . @ . . . . . . . @ . . . . . . . @ . . . . . . . @ . . . . . . . @ . . . . . . . 
@ . . . . . . . @ . . . . . . . @ . . . . . . . @ . . . . . . . @ . . . . . . . @ . . . . . . . @ . . . . . . . @ . . . . . . . 
. . . . . . . . @ . . . . . . . @ . . . . . . . @ . . . . . . . @ . . . . . . . @ . . . . . . . @ . . . . . . . @ . . . . . . . 
@ . . . . . . . @ . . . . . . . @ . . . . . . . @ . . . . . . . @ . . . . . . . . . . . . . . . @ . . . . . . . @ . . . . . . . 
70 
42 35 20 28 
15 23 50 23 
26 10 42 62 
12 49 17 26 
43 57 41 17 
63 42 10 55 
60 44 6 58 
62 26 49 28 
30 58 17 22 
58 27 25 27 
62 59 61 58 
47 41 9 26 
31 28 28 20 
33 39 23 10 
58 61 35 42 
50 41 37 35 
3 43 38 17 
53 42 21 28 
36 34 2 50 
20 57 50 33 
18 29 4 6 
54 26 1 38 
29 11 17 29 
43 33 6 38 
54 2 51 22 
5 1 12 41 
43 51 33 17 
43 37 37 4 
22 18 54 36 
1 41 7 11 
14 49 49 42 
37 39 43 49 
6 1 18 51 
55 45 9 22 
14 22 7 23 
14 34 10 20 
30 59 28 9 
5 47 52 20 
37 30 27 55 
29 20 51 61 
20 0 26 49 
31 2 55 11 
62 58 59 36 
62 39 19 41 
60 17 14 51 
20 39 23 35 
24 41 18 63 
30 3 46 52 
10 34 23 61 
49 5 37 58 
34 51 47 47 
44 45 63 58 
50 12 5 4 
52 19 18 25 
29 49 60 25 
41 62 34 6 
25 41 25 12 
42 31 57 61 
57 2 17 39 
39 57 43 30 
62 34 31 18 
23 25 10 49 
1 25 57 12 
4 27 62 52 
52 35 59 48 
54 25 14 54 
58 49 6 37 
27 44 54 55 
54 10 28 21 
49 7 31 33 
