64 64 
@ @ @ . @ @ @ @ @ @ @ @ @ @ @ @ @ @ @ . @ @ @ @ @ @ . @ @ @ @ @ @ @ . @ @ @ @ @ @ @ @ @ @ @ @ @ @ . @ @ @ @ @ @ @ . @ @ @ @ @ @ 
@ . . . . . . . @ . . . . . . . @ . . . . . . . @ . . . . . . . @ . . . . . . . @ . . . . . . . @ . . . . . . . @ . . . . . . . 
@ . . . . . . . @ . . . . . . . @ . . . . . . . @ . . . . . . . @ . . . . . . . @ . . . . . . . @ . . . . . . . @ . . . . . . . 
. . . . . . . . @ . . . . . . . @ . . . . . . . @ . . . . . . . @ . . . . . . . @ . . . . . . . @ . . . . . . . @ . . . . . . . 
@ . . . . . . . @ . . . . . . . @ . . . . . . . @ . . . . . . . @ . . . . . . . @ . . . . . . . @ . . . . . . . @ . . . . . . . 
@ . . . . . . . . . . . . . . . . . . . . . . . @ . . . . . . . @ . . . . . . . @ . . . . . . . @ . . . . . . . . . . . . . . . 
@ . . . . . . . @ . . . . . . . @ . . . . . . . @ . . . . . . . @ . . . . . . . @ . . . . . . . @ . . . . . . . @ . . . . . . . 
@ . . . . . . . @ . . . . . . . @ . . . . . . . . . . . . . . . . . . . . . . . @ . . . . . . . . . . . . . . . @ . . . . . . . 
@ . @ @ @ @ @ @ @ @ @ @ @ . @ @ @ @ @ @ @ . @ @ @ . @ @ @ @ @ @ @ . @ @ @ @ @ @ @ @ @ @ @ @ @ . @ @ @ @ @ @ . @ @ . @ @ @ @ @ @ 
@ . . . . . . . @ . . . . . . . @ . . . . . . . @ . . . . . . . @ . . . . . . . @ . . . . . . . @ . . . . . . . @ . . . . . . . 
@ . . . . . . . @ . . . . . . . @ . . . . . . . . . . . . . . . . . . . . . . . @ . . . . . . . @ . . . . . . . @ . . . . . . . 
@ . . . . . . . @ . . . . . . . @ . . . . . . . @ . . . . . . . @ . . . . . . . @ . . . . . . . @ . . . . . . . @ . . . . . . . 
. . . . . . . . . . . . . . . . @ . . . . . . . @ . . . . . . . @ . . . . . . . @ . . . . . . . . . . . . . . . @ . . . . . . . 
@ . . . . . . . @ . . . . . . . @ . . . . . . . @ . . . . . . . @ . . . . . . . . . . . . . . . @ . . . . . . . @ . . . . . . . 
@ . . . . . . . @ . . . . . . . @ . . . . . . . @ . . . . . . . @ . . . . . . . @ . . . . . . . @ . . . . . . . . . . . . . . . 
@ . . . . . . . @ . . . . . . . @ . . . . . . . @ . . . . . . . @ . . . . . . . @ . . . . . . . @ . . . . . . . @ . . . . . . . 
@ @ @ @ @ @ @ . @ @ @ @ @ . @ @ @ @ @ @ @ @ @ @ @ @ @ @ @ @ . @ @ @ @ @ @ @ @ @ @ @ @ @ @ . @ @ @ @ @ @ @ @ @ . @ @ @ @ @ @ . @ 
@ . . . . . . . @ . . . . . . . @ . . . . . . . @ . . . . . . . @ . . . . . . . @ . . . . . . . @ . . . . . . . @ . . . . . . . 
@ . . . . . . . @ . . . . . . . @ . . . . . . . @ . . . . . . . @ . . . . . . . . . . . . . . . @ . . . . . . . @ . . . . . . . 
@ . . . . . . . @ . . . . . . . @ . . . . . . . @ . . . . . . . @ . . . . . . . @ . . . . . . . @ . . . . . . . @ . . . . . . . 
. . . . . . . . @ . . . . . . . @ . . . . . . . . . . . . . . . @ . . . . . . . @ . . . . . . . . . . . . . . . @ . . . . . . . 
@ . . . . . . . @ . . . . . . . @ . . . . . . . @ . . . . . . . @ . . . . . . . @ . . . . . . . @ . . . . . . . @ . . . . . . . 
@ . . . . . . . . . . . . . . . @ . . . . . . . @ . . . . . . . @ . . . . . . . @ . . . . . . . @ . . . . . . . @ . . . . . . . 
@ . . . . . . . @ . . . . . . . @ . . . . . . . @ . . . . . . . @ . . . . . . . @ . . . . . . . @ . . . . . . . @ . . . . . . . 
@ . @ @ @ @ @ @ @ @ . @ @ @ @ @ @ @ @ @ @ . @ @ @ @ @ @ @ @ . @ @ @ @ @ @ @ . @ @ . @ @ @ @ @ @ @ . @ @ @ @ @ @ @ @ @ @ @ @ @ . 
@ . . . . . . . . . . . . . . . @ . . . . . . . @ . . . . . . . @ . . . . . . . @ . . . . . . . @ . . . . . . . @ . . . . . . . 
@ . . . . . . . @ . . . . . . . @ . . . . . . . @ . . . . . . . @ . . . . . . . @ . . . . . . . @ . . . . . . . @ . . . . . . . 
@ . . . . . . . @ . . . . . . . @ . . . . . . . @ . . . . . . . . . . . . . . . @ . . . . . . . @ . . . . . . . @ . . . . . . . 
@ . . . . . . . @ . . . . . . . @ . . . . . . . @ . . . . . . . @ . . . . . . . @ . . . . . . . @ . . . . . . . @ . . . . . . . 
. . . . . . . . @ . . . . . . . @ . . . . . . . @ . . . . . . . @ . . . . . . . @ . . . . . . . @ . . . . . . . @ . . . . . . . 
@ . . . . . . . @ . . . . . . . @ . . . . . . . @ . . . . . . . @ . . . . . . . @ . . . . . . . @ . . . . . . . . . . . . . . . 
@ . . . . . . . @ . . . . . . . @ . . . . . . . . . . . . . . . @ . . . . . . . @ . . . . . . . @ . . . . . . . @ . . . . . . . 
@ @ @ @ @ @ @ @ @ @ @ @ @ @ @ @ @ @ . @ @ @ @ @ @ @ @ . @ @ @ @ @ @ @ @ @ @ @ @ @ @ @ @ @ @ @ @ @ @ @ @ @ @ @ . @ @ . @ @ @ @ @ 
@ . . . . . . . @ . . . . . . . @ . . . . . . . @ . . . . . . . @ . . . . . . . @ . . . . . . . @ . . . . . . . @ . . . . . . . 
@ . . . . . . . @ . . . . . . . @ . . . . . . . @ . . . . . . . . . . . . . . . @ . . . . . . . @ . . . . . . . @ . . . . . . . 
@ . . . . . . . @ . . . . . . . @ . . . . . . . @ . . . . . . . @ . . . . . . . @ . . . . . . . @ . . . . . . . @ . . . . . . . 
@ . . . . . . . . . . . . . . . @ . . . . . . . . . . . . . . . @ . . . . . . . @ . . . . . . . @ . . . . . . . @ . . . . . . . 
@ . . . . . . . @ . . . . . . . @ . . . . . . . @ . . . . . . . @ . . . . . . . @ . . . . . . . @ . . . . . . . . . . . . . . . 
. . . . . . . . @ . . . . . . . @ . . . . . . . @ . . . . . . . @ . . . . . . . . . . . . . . . @ . . . . . . . @ . . . . . . . 
@ . . . . . . . @ . . . . . . . @ . . . . . . . @ . . . . . . . @ . . . . . . . @ . . . . . . . @ . . . . . . . @ . . . . . . . 
@ @ @ @ @ @ @ . @ @ @ @ @ @ @ @ @ @ @ @ @ @ @ @ @ @ @ . @ @ @ @ @ @ . @ @ @ @ @ @ @ @ @ @ @ . @ @ @ @ @ . @ @ @ @ @ @ @ . @ @ @ 
@ . . . . . . . @ . . . . . . . @ . . . . . . . @ . . . . . . . @ . . . . . . . @ . . . . . . . . . . . . . . . @ . . . . . . . 
@ . . . . . . . @ . . . . . . . @ . . . . . . . . . . . . . . . . . . . . . . . @ . . . . . . . @ . . . . . . . @ . . . . . . . 
@ . . . . . . . @ . . . . . . . . . . . . . . . @ . . . . . . . @ . . . . . . . @ . . . . . . . @ . . . . . . . @ . . . . . . . 
@ . . . . . . . @ . . . . . . . @ . . . . . . . @ . . . . . . . @ . . . . . . . @ . . . . . . . @ . . . . . . . @ . . . . . . . 
@ . . . . . . . @ . . . . . . . @ . . . . . . . @ . . . . . . . @ . . . . . . . @ . . . . . . . @ . . . . . . . @ . . . . . . . 
@ . . . . . . . . . . . . . . . @ . . . . . . . @ . . . . . . . @ . . . . . . . @ . . . . . . . @ . . . . . . . @ . . . . . . . 
. . . . . . . . @ . . . . . . . @ . . . . . . . @ . . . . . . . @ . . . . . . . @ . . . . . . . @ . . . . . . . @ . . . . . . . 
@ @ @ @ . @ @ @ @ . @ @ @ @ @ @ @ @ . @ @ @ @ @ @ @ @ @ @ @ . @ @ @ @ @ @ @ @ @ @ @ @ @ @ @ . @ @ @ @ @ @ @ @ @ @ @ @ @ @ @ @ @ 
. . . . . . . . @ . . . . . . . @ . . . . . . . @ . . . . . . . @ . . . . . . . @ . . . . . . . @ . . . . . . . @ . . . . . . . 
@ . . . . . . . @ . . . . . . . @ . . . . . . . @ . . . . . . . @ . . . . . . . @ . . . . . . . @ . . . . . . . @ . . . . . . . 
@ . . . . . . . @ . . . . . . . @ . . . . . . . @ . . . . . . . @ . . . . . . . @ . . . . . . . @ . . . . . . . @ . . . . . . . 
@ . . . . . . . @ . . . . . . . @ . . . . . . . @ . . . . . . . @ . . . . . . . @ . . . . . . . @ . . . . . . . . . . . . . . . 
@ . . . . . . . @ . . . . . . . @ . . . . . . . @ . . . . . . . @ . . . . . . . @ . . . . . . . @ . . . . . . . @ . . . . . . . 
@ . . . . . . . @ . . . . . . . @ . . . . . . . @ . . . . . . . @ . . . . . . . @ . . . . . . . @ . . . . . . . @ . . . . . . . 
@ . . . . . . . @ . . . . . . . . . . . . . . . . . . . . . . . . . . . . . . . . . . . . . . . @ . . . . . . . @ . . . . . . . 
@ @ @ @ @ @ @ @ @ @ @ . @ @ @ @ @ @ @ @ @ @ @ @ @ @ @ @ @ @ @ . @ @ @ @ @ @ @ @ @ @ @ @ @ . @ @ @ @ @ @ @ @ @ . @ @ @ @ @ @ @ @ 
@ . . . . . . . @ . . . . . . . @ . . . . . . . @ . . . . . . . @ . . . . . . . @ . . . . . . . @ . . . . . . . @ . . . . . . . 
@ . . . . . . . . . . . . . . . . . . . . . . . @ . . . . . . . @ . . . . . . . @ . . . . . . . @ . . . . . . . @ . . . . . . . 
@ . . . . . . . @ . . . . . . . @ . . . . . . . . . . . . . . . @ . . . . . . . @ . . . . . . . . . . . . . . . . . . . . . . . 
@ . . . . . . . @ . . . . . . . @ . . . . . . . @ . . . . . . . @ . . . . . . . @ . . . . . . . @ . . . . . . . @ . . . . . . . 
@ . . . . . . . @ . . . . . . . @ . . . . . . . @ . . . . . . . @ . . . . . . . @ . . . . . . . @ . . . . . . . @ . . . . . . . 
. . . . . . . . @ . . . . . . . @ . . . . . . . @ . . . . . . . @ . . . . . . . @ . . . . . . . @ . . . . . . . @ . . . . . . . 
@ . . . . . . . @ . . . . . . . @ . . . . . . . @ . . . . . . . @ . . . . . . . . . . . . . . . @ . . . . . . . @ . . . . . . . 
100 
30 35 12 46 
7 29 7 58 
43 16 59 4 
52 17 52 26 
47 60 30 52 
20 46 57 60 
9 41 58 1 
52 7 52 10 
53 36 28 54 
45 19 1 57 
60 26 37 35 
26 51 51 57 
63 19 20 7 
44 30 7 9 
34 31 30 55 
61 4 61 11 
4 38 27 61 
59 25 49 11 
59 12 37 55 
44 41 17 54 
42 41 61 54 
29 19 29 46 
54 34 39 26 
55 16 29 33 
18 26 44 4 
61 44 39 41 
29 36 28 20 
57 51 34 60 
46 57 18 39 
46 54 12 12 
9 55 31 9 
30 3 17 42 
63 34 54 57 
21 46 51 59 
41 33 2 49 
34 42 42 39 
29 25 61 39 
39 54 31 58 
39 3 47 1 
22 38 17 63 
26 1 9 20 
26 38 25 55 
19 12 60 58 
13 28 44 10 
6 3 29 57 
14 11 42 58 
17 59 9 50 
59 35 59 14 
26 43 36 9 
57 22 18 53 
10 63 36 23 
37 5 26 31 
6 11 6 62 
59 2 60 43 
33 57 20 53 
26 7 9 61 
38 11 50 17 
19 57 11 20 
12 57 10 62 
63 35 54 33 
9 63 50 4 
1 49 37 28 
50 11 58 52 
58 2 22 53 
22 45 9 49 
11 17 36 52 
31 5 54 45 
20 48 50 44 
12 17 26 23 
15 54 63 26 
55 53 14 41 
13 36 60 50 
25 35 18 5 
21 30 22 50 
33 37 42 43 
17 10 58 10 
6 45 36 24 
7 35 50 36 
46 13 28 19 
60 22 45 37 
55 31 27 62 
18 51 49 18 
39 30 30 57 
9 26 47 61 
51 54 7 53 
6 4 21 26 
22 2 55 33 
47 31 61 61 
25 47 32 18 
18 37 49 29 
49 19 58 51 
51 2 4 6 
36 28 57 57 
61 46 39 29 
21 2 49 62 
55 1 61 22 
33 47 62 3 
7 27 63 62 
35 35 35 22 
51 42 22 6 
