64 64 
@ . @ @ @ @ @ @ @ @ @ @ . @ @ @ @ @ @ @ @ @ @ @ @ . @ . @ @ @ @ @ @ @ @ @ @ @ @ . @ @ . @ @ @ @ @ @ @ @ @ @ @ @ @ @ @ . . @ @ @ 
@ . . . . . . . . . . . . . . . @ . . . . . . . . . . . . . . . @ . . . . . . . . . . . . . . . @ . . . . . . . . . . . . . . . 
@ . . . . . . . . . . . . . . . @ . . . . . . . . . . . . . . . @ . . . . . . . . . . . . . . . @ . . . . . . . . . . . . . . . 
@ . . . . . . . . . . . . . . . @ . . . . . . . . . . . . . . . @ . . . . . . . . . . . . . . . . . . . . . . . . . . . . . . . 
@ . . . . . . . . . . . . . . . @ . . . . . . . . . . . . . . . @ . . . . . . . . . . . . . . . @ . . . . . . . . . . . . . . . 
@ . . . . . . . . . . . . . . . @ . . . . . . . . . . . . . . . @ . . . . . . . . . . . . . . . @ . . . . . . . . . . . . . . . 
@ . . . . . . . . . . . . . . . @ . . . . . . . . . . . . . . . @ . . . . . . . . . . . . . . . @ . . . . . . . . . . . . . . . 
@ . . . . . . . . . . . . . . . @ . . . . . . . . . . . . . . . @ . . . . . . . . . . . . . . . . . . . . . . . . . . . . . . . 
@ . . . . . . . . . . . . . . . @ . . . . . . . . . . . . . . . @ . . . . . . . . . . . . . . . @ . . . . . . . . . . . . . . . 
@ . . . . . . . . . . . . . . . . . . . . . . . . . . . . . . . @ . . . . . . . . . . . . . . . @ . . . . . . . . . . . . . . . 
@ . . . . . . . . . . . . . . . @ . . . . . . . . . . . . . . . @ . . . . . . . . . . . . . . . @ . . . . . . . . . . . . . . . 
@ . . . . . . . . . . . . . . . . . . . . . . . . . . . . . . . . . . . . . . . . . . . . . . . @ . . . . . . . . . . . . . . . 
@ . . . . . . . . . . . . . . . @ . . . . . . . . . . . . . . . @ . . . . . . . . . . . . . . . @ . . . . . . . . . . . . . . . 
@ . . . . . . . . . . . . . . . @ . . . . . . . . . . . . . . . @ . . . . . . . . . . . . . . . @ . . . . . . . . . . . . . . . 
@ . . . . . . . . . . . . . . . @ . . . . . . . . . . . . . . . . . . . . . . . . . . . . . . . @ . . . . . . . . . . . . . . . 
@ . . . . . . . . . . . . . . . @ . . . . . . . . . . . . . . . @ . . . . . . . . . . . . . . . @ . . . . . . . . . . . . . . . 
@ . @ @ @ @ @ @ @ @ @ @ @ @ @ @ @ @ @ @ @ @ @ @ @ @ @ @ @ @ @ @ @ @ @ @ @ . @ @ @ . @ @ @ @ @ @ @ @ @ @ . @ @ @ @ @ @ @ @ @ @ . 
@ . . . . . . . . . . . . . . . @ . . . . . . . . . . . . . . . @ . . . . . . . . . . . . . . . @ . . . . . . . . . . . . . . . 
. . . . . . . . . . . . . . . . @ . . . . . . . . . . . . . . . @ . . . . . . . . . . . . . . . @ . . . . . . . . . . . . . . . 
@ . . . . . . . . . . . . . . . @ . . . . . . . . . . . . . . . @ . . . . . . . . . . . . . . . @ . . . . . . . . . . . . . . . 
. . . . . . . . . . . . . . . . @ . . . . . . . . . . . . . . . . . . . . . . . . . . . . . . . @ . . . . . . . . . . . . . . . 
@ . . . . . . . . . . . . . . . @ . . . . . . . . . . . . . . . @ . . . . . . . . . . . . . . . @ . . . . . . . . . . . . . . . 
@ . . . . . . . . . . . . . . . @ . . . . . . . . . . . . . . . @ . . . . . . . . . . . . . . . . . . . . . . . . . . . . . . . 
@ . . . . . . . . . . . . . . . @ . . . . . . . . . . . . . . . @ . . . . . . . . . . . . . . . @ . . . . . . . . . . . . . . . 
@ . . . . . . . . . . . . . . . @ . . . . . . . . . . . . . . . @ . . . . . . . . . . . . . . . @ . . . . . . . . . . . . . . . 
@ . . . . . . . . . . . . . . . @ . . . . . . . . . . . . . . . @ . . . . . . . . . . . . . . . @ . . . . . . . . . . . . . . . 
@ . . . . . . . . . . . . . . . @ . . . . . . . . . . . . . . . @ . . . . . . . . . . . . . . . @ . . . . . . . . . . . . . . . 
@ . . . . . . . . . . . . . . . @ . . . . . . . . . . . . . . . @ . . . . . . . . . . . . . . . @ . . . . . . . . . . . . . . . 
@ . . . . . . . . . . . . . . . @ . . . . . . . . . . . . . . . @ . . . . . . . . . . . . . . . @ . . . . . . . . . . . . . . . 
@ . . . . . . . . . . . . . . . @ . . . . . . . . . . . . . . . @ . . . . . . . . . . . . . . . . . . . . . . . . . . . . . . . 
@ . . . . . . . . . . . . . . . @ . . . . . . . . . . . . . . . @ . . . . . . . . . . . . . . . @ . . . . . . . . . . . . . . . 
@ . . . . . . . . . . . . . . . @ . . . . . . . . . . . . . . . @ . . . . . . . . . . . . . . . @ . . . . . . . . . . . . . . . 
@ @ @ @ @ @ @ . @ . @ @ @ @ @ @ @ @ @ @ @ @ @ @ @ @ @ @ @ @ @ @ @ @ @ @ @ @ @ @ @ @ @ @ . @ @ . @ @ @ @ @ @ @ @ @ @ @ @ @ @ @ @ 
@ . . . . . . . . . . . . . . . @ . . . . . . . . . . . . . . . @ . . . . . . . . . . . . . . . . . . . . . . . . . . . . . . . 
. . . . . . . . . . . . . . . . @ . . . . . . . . . . . . . . . @ . . . . . . . . . . . . . . . @ . . . . . . . . . . . . . . . 
@ . . . . . . . . . . . . . . . @ . . . . . . . . . . . . . . . @ . . . . . . . . . . . . . . . @ . . . . . . . . . . . . . . . 
@ . . . . . . . . . . . . . . . @ . . . . . . . . . . . . . . . @ . . . . . . . . . . . . . . . @ . . . . . . . . . . . . . . . 
@ . . . . . . . . . . . . . . . @ . . . . . . . . . . . . . . . . . . . . . . . . . . . . . . . @ . . . . . . . . . . . . . . . 
@ . . . . . . . . . . . . . . . @ . . . . . . . . . . . . . . . @ . . . . . . . . . . . . . . . @ . . . . . . . . . . . . . . . 
@ . . . . . . . . . . . . . . . @ . . . . . . . . . . . . . . . @ . . . . . . . . . . . . . . . @ . . . . . . . . . . . . . . . 
@ . . . . . . . . . . . . . . . @ . . . . . . . . . . . . . . . @ . . . . . . . . . . . . . . . @ . . . . . . . . . . . . . . . 
@ . . . . . . . . . . . . . . . @ . . . . . . . . . . . . . . . . . . . . . . . . . . . . . . . @ . . . . . . . . . . . . . . . 
@ . . . . . . . . . . . . . . . @ . . . . . . . . . . . . . . . @ . . . . . . . . . . . . . . . @ . . . . . . . . . . . . . . . 
. . . . . . . . . . . . . . . . @ . . . . . . . . . . . . . . . @ . . . . . . . . . . . . . . . @ . . . . . . . . . . . . . . . 
@ . . . . . . . . . . . . . . . @ . . . . . . . . . . . . . . . @ . . . . . . . . . . . . . . . . . . . . . . . . . . . . . . . 
@ . . . . . . . . . . . . . . . @ . . . . . . . . . . . . . . . @ . . . . . . . . . . . . . . . @ . . . . . . . . . . . . . . . 
@ . . . . . . . . . . . . . . . @ . . . . . . . . . . . . . . . @ . . . . . . . . . . . . . . . @ . . . . . . . . . . . . . . . 
@ . . . . . . . . . . . . . . . @ . . . . . . . . . . . . . . . @ . . . . . . . . . . . . . . . @ . . . . . . . . . . . . . . . 
@ . @ @ @ @ . @ @ @ @ @ @ @ @ @ @ @ @ @ @ @ @ @ @ @ @ @ @ @ @ @ @ . . @ @ @ @ @ @ @ @ @ @ @ @ @ @ @ @ @ @ @ @ @ @ . @ . @ @ @ @ 
@ . . . . . . . . . . . . . . . @ . . . . . . . . . . . . . . . @ . . . . . . . . . . . . . . . @ . . . . . . . . . . . . . . . 
@ . . . . . . . . . . . . . . . @ . . . . . . . . . . . . . . . @ . . . . . . . . . . . . . . . @ . . . . . . . . . . . . . . . 
@ . . . . . . . . . . . . . . . @ . . . . . . . . . . . . . . . @ . . . . . . . . . . . . . . . @ . . . . . . . . . . . . . . . 
@ . . . . . . . . . . . . . . . @ . . . . . . . . . . . . . . . @ . . . . . . . . . . . . . . . @ . . . . . . . . . . . . . . . 
@ . . . . . . . . . . . . . . . @ . . . . . . . . . . . . . . . @ . . . . . . . . . . . . . . . @ . . . . . . . . . . . . . . . 
@ . . . . . . . . . . . . . . . @ . . . . . . . . . . . . . . . @ . . . . . . . . . . . . . . . @ . . . . . . . . . . . . . . . 
@ . . . . . . . . . . . . . . . @ . . . . . . . . . . . . . . . @ . . . . . . . . . . . . . . . . . . . . . . . . . . . . . . . 
@ . . . . . . . . . . . . . . . @ . . . . . . . . . . . . . . . @ . . . . . . . . . . . . . . . @ . . . . . . . . . . . . . . . 
@ . . . . . . . . . . . . . . . . . . . . . . . . . . . . . . . @ . . . . . . . . . . . . . . . @ . . . . . . . . . . . . . . . 
. . . . . . . . . . . . . . . . @ . . . . . . . . . . . . . . . @ . . . . . . . . . . . . . . . @ . . . . . . . . . . . . . . . 
@ . . . . . . . . . . . . . . . @ . . . . . . . . . . . . . . . @ . . . . . . . . . . . . . . . @ . . . . . . . . . . . . . . . 
@ . . . . . . . . . . . . . . . @ . . . . . . . . . . . . . . . @ . . . . . . . . . . . . . . . @ . . . . . . . . . . . . . . . 
@ . . . . . . . . . . . . . . . @ . . . . . . . . . . . . . . . @ . . . . . . . . . . . . . . . @ . . . . . . . . . . . . . . . 
@ . . . . . . . . . . . . . . . @ . . . . . . . . . . . . . . . @ . . . . . . . . . . . . . . . . . . . . . . . . . . . . . . . 
. . . . . . . . . . . . . . . . . . . . . . . . . . . . . . . . @ . . . . . . . . . . . . . . . @ . . . . . . . . . . . . . . . 
90 
21 52 33 59 
26 34 28 42 
47 22 23 57 
41 46 35 9 
28 3 46 11 
21 35 14 12 
36 55 44 52 
39 58 56 5 
41 26 56 8 
22 51 28 46 
20 11 55 23 
26 11 34 58 
18 46 28 53 
10 4 25 55 
49 49 54 18 
51 55 33 25 
3 2 59 59 
1 26 8 60 
45 47 12 56 
28 18 62 7 
46 51 61 10 
50 11 5 34 
1 8 15 59 
36 29 42 44 
43 52 12 8 
3 36 43 56 
17 14 26 25 
34 43 1 20 
13 10 47 39 
60 55 15 62 
23 6 58 57 
58 8 3 18 
38 4 4 26 
35 42 29 49 
54 40 3 63 
46 13 26 18 
24 17 11 45 
44 6 21 40 
44 44 1 34 
29 43 17 36 
56 23 1 49 
55 56 59 25 
17 44 5 57 
57 50 57 8 
25 1 58 20 
25 34 63 33 
8 10 51 42 
23 24 26 35 
44 30 15 15 
51 35 5 39 
42 6 49 2 
36 58 3 39 
38 10 26 38 
41 38 4 47 
27 27 24 63 
31 26 44 29 
49 44 15 46 
59 36 50 55 
54 56 63 39 
6 4 28 44 
18 55 27 35 
7 34 12 1 
36 31 56 7 
13 45 1 51 
44 28 20 8 
12 14 45 52 
28 23 3 51 
59 28 11 30 
10 43 53 4 
9 58 45 13 
20 12 22 30 
42 24 15 20 
4 62 27 9 
18 11 46 25 
41 17 36 44 
50 20 34 52 
4 36 45 58 
38 36 7 14 
36 11 27 30 
25 56 52 9 
14 23 11 18 
60 37 42 40 
44 48 63 30 
29 37 47 47 
22 33 11 40 
17 24 61 31 
34 2 60 7 
31 21 43 47 
19 51 18 42 
47 62 46 5 
