64 64 
@ . @ @ @ @ @ @ @ @ @ @ . @ @ @ @ @ @ @ @ @ @ @ @ . @ . @ @ @ @ @ @ @ @ @ @ @ @ . @ @ . @ @ @ @ @ @ @ @ @ @ @ @ @ @ @ . . @ @ @ 
@ . . . . . . . . . . . . . . . @ . . . . . . . . . . . . . . . @ . . . . . . . . . . . . . . . @ . . . . . . . . . . . . . . . 
@ . . . . . . . . . . . . . . . @ . . . . . . . . . . . . . . . @ . . . . . . . . . . . . . . . @ . . . . . . . . . . . . . . . 
@ . . . . . . . . . . . . . . . @ . . . . . . . . . . . . . . . @ . . . . . . . . . . . . . . . . . . . . . . . . . . . . . . . 
@ . . . . . . . . . . . . . . . @ . . . . . . . . . . . . . . . @ . . . . . . . . . . . . . . . @ . . . . . . . . . . . . . . . 
@ . . . . . . . . . . . . . . . @ . . . . . . . . . . . . . . . @ . . . . . . . . . . . . . . . @ . . . . . . . . . . . . . . . 
@ . . . . . . . . . . . . . . . @ . . . . . . . . . . . . . . . @ . . . . . . . . . . . . . . . @ . . . . . . . . . . . . . . . 
@ . . . . . . . . . . . . . . . @ . . . . . . . . . . . . . . . @ . . . . . . . . . . . . . . . . . . . . . . . . . . . . . . . 
@ . . . . . . . . . . . . . . . @ . . . . . . . . . . . . . . . @ . . . . . . . . . . . . . . . @ . . . . . . . . . . . . . . . 
@ . . . . . . . . . . . . . . . . . . . . . . . . . . . . . . . @ . . . . . . . . . . . . . . . @ . . . . . . . . . . . . . . . 
@ . . . . . . . . . . . . . . . @ . . . . . . . . . . . . . . . @ . . . . . . . . . . . . . . . @ . . . . . . . . . . . . . . . 
@ . . . . . . . . . . . . . . . . . . . . . . . . . . . . . . . . . . . . . . . . . . . . . . . @ . . . . . . . . . . . . . . . 
@ . . . . . . . . . . . . . . . @ . . . . . . . . . . . . . . . @ . . . . . . . . . . . . . . . @ . . . . . . . . . . . . . . . 
@ . . . . . . . . . . . . . . . @ . . . . . . . . . . . . . . . @ . . . . . . . . . . . . . . . @ . . . . . . . . . . . . . . . 
@ . . . . . . . . . . . . . . . @ . . . . . . . . . . . . . . . . . . . . . . . . . . . . . . . @ . . . . . . . . . . . . . . . 
@ . . . . . . . . . . . . . . . @ . . . . . . . . . . . . . . . @ . . . . . . . . . . . . . . . @ . . . . . . . . . . . . . . . 
@ . @ @ @ @ @ @ @ @ @ @ @ @ @ @ @ @ @ @ @ @ @ @ @ @ @ @ @ @ @ @ @ @ @ @ @ . @ @ @ . @ @ @ @ @ @ @ @ @ @ . @ @ @ @ @ @ @ @ @ @ . 
@ . . . . . . . . . . . . . . . @ . . . . . . . . . . . . . . . @ . . . . . . . . . . . . . . . @ . . . . . . . . . . . . . . . 
. . . . . . . . . . . . . . . . @ . . . . . . . . . . . . . . . @ . . . . . . . . . . . . . . . @ . . . . . . . . . . . . . . . 
@ . . . . . . . . . . . . . . . @ . . . . . . . . . . . . . . . @ . . . . . . . . . . . . . . . @ . . . . . . . . . . . . . . . 
. . . . . . . . . . . . . . . . @ . . . . . . . . . . . . . . . . . . . . . . . . . . . . . . . @ . . . . . . . . . . . . . . . 
@ . . . . . . . . . . . . . . . @ . . . . . . . . . . . . . . . @ . . . . . . . . . . . . . . . @ . . . . . . . . . . . . . . . 
@ . . . . . . . . . . . . . . . @ . . . . . . . . . . . . . . . @ . . . . . . . . . . . . . . . . . . . . . . . . . . . . . . . 
@ . . . . . . . . . . . . . . . @ . . . . . . . . . . . . . . . @ . . . . . . . . . . . . . . . @ . . . . . . . . . . . . . . . 
@ . . . . . . . . . . . . . . . @ . . . . . . . . . . . . . . . @ . . . . . . . . . . . . . . . @ . . . . . . . . . . . . . . . 
@ . . . . . . . . . . . . . . . @ . . . . . . . . . . . . . . . @ . . . . . . . . . . . . . . . @ . . . . . . . . . . . . . . . 
@ . . . . . . . . . . . . . . . @ . . . . . . . . . . . . . . . @ . . . . . . . . . . . . . . . @ . . . . . . . . . . . . . . . 
@ . . . . . . . . . . . . . . . @ . . . . . . . . . . . . . . . @ . . . . . . . . . . . . . . . @ . . . . . . . . . . . . . . . 
@ . . . . . . . . . . . . . . . @ . . . . . . . . . . . . . . . @ . . . . . . . . . . . . . . . @ . . . . . . . . . . . . . . . 
@ . . . . . . . . . . . . . . . @ . . . . . . . . . . . . . . . @ . . . . . . . . . . . . . . . . . . . . . . . . . . . . . . . 
@ . . . . . . . . . . . . . . . @ . . . . . . . . . . . . . . . @ . . . . . . . . . . . . . . . @ . . . . . . . . . . . . . . . 
@ . . . . . . . . . . . . . . . @ . . . . . . . . . . . . . . . @ . . . . . . . . . . . . . . . @ . . . . . . . . . . . . . . . 
@ @ @ @ @ @ @ . @ . @ @ @ @ @ @ @ @ @ @ @ @ @ @ @ @ @ @ @ @ @ @ @ @ @ @ @ @ @ @ @ @ @ @ . @ @ . @ @ @ @ @ @ @ @ @ @ @ @ @ @ @ @ 
@ . . . . . . . . . . . . . . . @ . . . . . . . . . . . . . . . @ . . . . . . . . . . . . . . . . . . . . . . . . . . . . . . . 
. . . . . . . . . . . . . . . . @ . . . . . . . . . . . . . . . @ . . . . . . . . . . . . . . . @ . . . . . . . . . . . . . . . 
@ . . . . . . . . . . . . . . . @ . . . . . . . . . . . . . . . @ . . . . . . . . . . . . . . . @ . . . . . . . . . . . . . . . 
@ . . . . . . . . . . . . . . . @ . . . . . . . . . . . . . . . @ . . . . . . . . . . . . . . . @ . . . . . . . . . . . . . . . 
@ . . . . . . . . . . . . . . . @ . . . . . . . . . . . . . . . . . . . . . . . . . . . . . . . @ . . . . . . . . . . . . . . . 
@ . . . . . . . . . . . . . . . @ . . . . . . . . . . . . . . . @ . . . . . . . . . . . . . . . @ . . . . . . . . . . . . . . . 
@ . . . . . . . . . . . . . . . @ . . . . . . . . . . . . . . . @ . . . . . . . . . . . . . . . @ . . . . . . . . . . . . . . . 
@ . . . . . . . . . . . . . . . @ . . . . . . . . . . . . . . . @ . . . . . . . . . . . . . . . @ . . . . . . . . . . . . . . . 
@ . . . . . . . . . . . . . . . @ . . . . . . . . . . . . . . . . . . . . . . . . . . . . . . . @ . . . . . . . . . . . . . . . 
@ . . . . . . . . . . . . . . . @ . . . . . . . . . . . . . . . @ . . . . . . . . . . . . . . . @ . . . . . . . . . . . . . . . 
. . . . . . . . . . . . . . . . @ . . . . . . . . . . . . . . . @ . . . . . . . . . . . . . . . @ . . . . . . . . . . . . . . . 
@ . . . . . . . . . . . . . . . @ . . . . . . . . . . . . . . . @ . . . . . . . . . . . . . . . . . . . . . . . . . . . . . . . 
@ . . . . . . . . . . . . . . . @ . . . . . . . . . . . . . . . @ . . . . . . . . . . . . . . . @ . . . . . . . . . . . . . . . 
@ . . . . . . . . . . . . . . . @ . . . . . . . . . . . . . . . @ . . . . . . . . . . . . . . . @ . . . . . . . . . . . . . . . 
@ . . . . . . . . . . . . . . . @ . . . . . . . . . . . . . . . @ . . . . . . . . . . . . . . . @ . . . . . . . . . . . . . . . 
@ . @ @ @ @ . @ @ @ @ @ @ @ @ @ @ @ @ @ @ @ @ @ @ @ @ @ @ @ @ @ @ . . @ @ @ @ @ @ @ @ @ @ @ @ @ @ @ @ @ @ @ @ @ @ . @ . @ @ @ @ 
@ . . . . . . . . . . . . . . . @ . . . . . . . . . . . . . . . @ . . . . . . . . . . . . . . . @ . . . . . . . . . . . . . . . 
@ . . . . . . . . . . . . . . . @ . . . . . . . . . . . . . . . @ . . . . . . . . . . . . . . . @ . . . . . . . . . . . . . . . 
@ . . . . . . . . . . . . . . . @ . . . . . . . . . . . . . . . @ . . . . . . . . . . . . . . . @ . . . . . . . . . . . . . . . 
@ . . . . . . . . . . . . . . . @ . . . . . . . . . . . . . . . @ . . . . . . . . . . . . . . . @ . . . . . . . . . . . . . . . 
@ . . . . . . . . . . . . . . . @ . . . . . . . . . . . . . . . @ . . . . . . . . . . . . . . . @ . . . . . . . . . . . . . . . 
@ . . . . . . . . . . . . . . . @ . . . . . . . . . . . . . . . @ . . . . . . . . . . . . . . . @ . . . . . . . . . . . . . . . 
@ . . . . . . . . . . . . . . . @ . . . . . . . . . . . . . . . @ . . . . . . . . . . . . . . . . . . . . . . . . . . . . . . . 
@ . . . . . . . . . . . . . . . @ . . . . . . . . . . . . . . . @ . . . . . . . . . . . . . . . @ . . . . . . . . . . . . . . . 
@ . . . . . . . . . . . . . . . . . . . . . . . . . . . . . . . @ . . . . . . . . . . . . . . . @ . . . . . . . . . . . . . . . 
. . . . . . . . . . . . . . . . @ . . . . . . . . . . . . . . . @ . . . . . . . . . . . . . . . @ . . . . . . . . . . . . . . . 
@ . . . . . . . . . . . . . . . @ . . . . . . . . . . . . . . . @ . . . . . . . . . . . . . . . @ . . . . . . . . . . . . . . . 
@ . . . . . . . . . . . . . . . @ . . . . . . . . . . . . . . . @ . . . . . . . . . . . . . . . @ . . . . . . . . . . . . . . . 
@ . . . . . . . . . . . . . . . @ . . . . . . . . . . . . . . . @ . . . . . . . . . . . . . . . @ . . . . . . . . . . . . . . . 
@ . . . . . . . . . . . . . . . @ . . . . . . . . . . . . . . . @ . . . . . . . . . . . . . . . . . . . . . . . . . . . . . . . 
. . . . . . . . . . . . . . . . . . . . . . . . . . . . . . . . @ . . . . . . . . . . . . . . . @ . . . . . . . . . . . . . . . 
90 
26 20 12 12 
11 29 52 2 
42 55 12 35 
15 17 39 35 
2 2 44 33 
14 9 6 18 
8 4 40 10 
18 46 37 7 
56 15 31 7 
14 46 28 12 
6 38 17 29 
19 22 18 8 
26 9 54 23 
57 26 11 54 
7 50 31 14 
30 63 60 51 
10 13 30 9 
43 49 1 33 
30 49 61 45 
37 45 55 42 
10 60 51 5 
41 10 14 32 
25 26 10 10 
28 57 23 2 
12 40 58 63 
2 53 25 21 
23 8 5 6 
40 5 45 21 
59 10 37 53 
46 10 54 27 
44 54 35 47 
26 24 4 23 
58 58 22 26 
61 28 10 31 
22 27 43 4 
46 34 47 20 
11 37 44 22 
23 22 37 25 
44 47 29 35 
50 31 33 31 
11 42 29 43 
31 19 39 13 
4 51 17 10 
35 25 56 20 
38 21 9 51 
14 1 63 24 
22 35 54 13 
2 49 16 52 
25 53 2 45 
15 25 22 23 
22 30 23 6 
1 61 36 9 
19 57 51 23 
49 11 15 59 
1 2 42 43 
3 20 35 36 
6 58 28 35 
19 25 7 57 
14 17 40 58 
9 31 62 41 
15 55 8 56 
59 8 5 7 
53 10 55 24 
39 6 28 49 
2 40 41 22 
55 11 31 55 
17 27 30 40 
25 31 24 5 
6 29 47 38 
50 23 58 14 
30 8 1 30 
38 27 50 58 
31 56 20 51 
60 58 54 20 
28 52 39 45 
40 49 59 61 
1 43 12 23 
23 26 8 19 
52 35 50 13 
19 53 35 7 
34 13 10 17 
40 37 3 39 
18 19 10 12 
35 44 59 23 
53 30 7 49 
63 42 17 58 
49 28 51 41 
62 28 47 42 
38 42 39 14 
10 53 52 61 
