64 64 
@ . @ @ @ @ @ @ @ @ @ @ . @ @ @ @ @ @ @ @ @ @ @ @ . @ . @ @ @ @ @ @ @ @ @ @ @ @ . @ @ . @ @ @ @ @ @ @ @ @ @ @ @ @ @ @ . . @ @ @ 
@ . . . . . . . . . . . . . . . @ . . . . . . . . . . . . . . . @ . . . . . . . . . . . . . . . @ . . . . . . . . . . . . . . . 
@ . . . . . . . . . . . . . . . @ . . . . . . . . . . . . . . . @ . . . . . . . . . . . . . . . @ . . . . . . . . . . . . . . . 
@ . . . . . . . . . . . . . . . @ . . . . . . . . . . . . . . . @ . . . . . . . . . . . . . . . . . . . . . . . . . . . . . . . 
@ . . . . . . . . . . . . . . . @ . . . . . . . . . . . . . . . @ . . . . . . . . . . . . . . . @ . . . . . . . . . . . . . . . 
@ . . . . . . . . . . . . . . . @ . . . . . . . . . . . . . . . @ . . . . . . . . . . . . . . . @ . . . . . . . . . . . . . . . 
@ . . . . . . . . . . . . . . . @ . . . . . . . . . . . . . . . @ . . . . . . . . . . . . . . . @ . . . . . . . . . . . . . . . 
@ . . . . . . . . . . . . . . . @ . . . . . . . . . . . . . . . @ . . . . . . . . . . . . . . . . . . . . . . . . . . . . . . . 
@ . . . . . . . . . . . . . . . @ . . . . . . . . . . . . . . . @ . . . . . . . . . . . . . . . @ . . . . . . . . . . . . . . . 
@ . . . . . . . . . . . . . . . . . . . . . . . . . . . . . . . @ . . . . . . . . . . . . . . . @ . . . . . . . . . . . . . . . 
@ . . . . . . . . . . . . . . . @ . . . . . . . . . . . . . . . @ . . . . . . . . . . . . . . . @ . . . . . . . . . . . . . . . 
@ . . . . . . . . . . . . . . . . . . . . . . . . . . . . . . . . . . . . . . . . . . . . . . . @ . . . . . . . . . . . . . . . 
@ . . . . . . . . . . . . . . . @ . . . . . . . . . . . . . . . @ . . . . . . . . . . . . . . . @ . . . . . . . . . . . . . . . 
@ . . . . . . . . . . . . . . . @ . . . . . . . . . . . . . . . @ . . . . . . . . . . . . . . . @ . . . . . . . . . . . . . . . 
@ . . . . . . . . . . . . . . . @ . . . . . . . . . . . . . . . . . . . . . . . . . . . . . . . @ . . . . . . . . . . . . . . . 
@ . . . . . . . . . . . . . . . @ . . . . . . . . . . . . . . . @ . . . . . . . . . . . . . . . @ . . . . . . . . . . . . . . . 
@ . @ @ @ @ @ @ @ @ @ @ @ @ @ @ @ @ @ @ @ @ @ @ @ @ @ @ @ @ @ @ @ @ @ @ @ . @ @ @ . @ @ @ @ @ @ @ @ @ @ . @ @ @ @ @ @ @ @ @ @ . 
@ . . . . . . . . . . . . . . . @ . . . . . . . . . . . . . . . @ . . . . . . . . . . . . . . . @ . . . . . . . . . . . . . . . 
. . . . . . . . . . . . . . . . @ . . . . . . . . . . . . . . . @ . . . . . . . . . . . . . . . @ . . . . . . . . . . . . . . . 
@ . . . . . . . . . . . . . . . @ . . . . . . . . . . . . . . . @ . . . . . . . . . . . . . . . @ . . . . . . . . . . . . . . . 
. . . . . . . . . . . . . . . . @ . . . . . . . . . . . . . . . . . . . . . . . . . . . . . . . @ . . . . . . . . . . . . . . . 
@ . . . . . . . . . . . . . . . @ . . . . . . . . . . . . . . . @ . . . . . . . . . . . . . . . @ . . . . . . . . . . . . . . . 
@ . . . . . . . . . . . . . . . @ . . . . . . . . . . . . . . . @ . . . . . . . . . . . . . . . . . . . . . . . . . . . . . . . 
@ . . . . . . . . . . . . . . . @ . . . . . . . . . . . . . . . @ . . . . . . . . . . . . . . . @ . . . . . . . . . . . . . . . 
@ . . . . . . . . . . . . . . . @ . . . . . . . . . . . . . . . @ . . . . . . . . . . . . . . . @ . . . . . . . . . . . . . . . 
@ . . . . . . . . . . . . . . . @ . . . . . . . . . . . . . . . @ . . . . . . . . . . . . . . . @ . . . . . . . . . . . . . . . 
@ . . . . . . . . . . . . . . . @ . . . . . . . . . . . . . . . @ . . . . . . . . . . . . . . . @ . . . . . . . . . . . . . . . 
@ . . . . . . . . . . . . . . . @ . . . . . . . . . . . . . . . @ . . . . . . . . . . . . . . . @ . . . . . . . . . . . . . . . 
@ . . . . . . . . . . . . . . . @ . . . . . . . . . . . . . . . @ . . . . . . . . . . . . . . . @ . . . . . . . . . . . . . . . 
@ . . . . . . . . . . . . . . . @ . . . . . . . . . . . . . . . @ . . . . . . . . . . . . . . . . . . . . . . . . . . . . . . . 
@ . . . . . . . . . . . . . . . @ . . . . . . . . . . . . . . . @ . . . . . . . . . . . . . . . @ . . . . . . . . . . . . . . . 
@ . . . . . . . . . . . . . . . @ . . . . . . . . . . . . . . . @ . . . . . . . . . . . . . . . @ . . . . . . . . . . . . . . . 
@ @ @ @ @ @ @ . @ . @ @ @ @ @ @ @ @ @ @ @ @ @ @ @ @ @ @ @ @ @ @ @ @ @ @ @ @ @ @ @ @ @ @ . @ @ . @ @ @ @ @ @ @ @ @ @ @ @ @ @ @ @ 
@ . . . . . . . . . . . . . . . @ . . . . . . . . . . . . . . . @ . . . . . . . . . . . . . . . . . . . . . . . . . . . . . . . 
. . . . . . . . . . . . . . . . @ . . . . . . . . . . . . . . . @ . . . . . . . . . . . . . . . @ . . . . . . . . . . . . . . . 
@ . . . . . . . . . . . . . . . @ . . . . . . . . . . . . . . . @ . . . . . . . . . . . . . . . @ . . . . . . . . . . . . . . . 
@ . . . . . . . . . . . . . . . @ . . . . . . . . . . . . . . . @ . . . . . . . . . . . . . . . @ . . . . . . . . . . . . . . . 
@ . . . . . . . . . . . . . . . @ . . . . . . . . . . . . . . . . . . . . . . . . . . . . . . . @ . . . . . . . . . . . . . . . 
@ . . . . . . . . . . . . . . . @ . . . . . . . . . . . . . . . @ . . . . . . . . . . . . . . . @ . . . . . . . . . . . . . . . 
@ . . . . . . . . . . . . . . . @ . . . . . . . . . . . . . . . @ . . . . . . . . . . . . . . . @ . . . . . . . . . . . . . . . 
@ . . . . . . . . . . . . . . . @ . . . . . . . . . . . . . . . @ . . . . . . . . . . . . . . . @ . . . . . . . . . . . . . . . 
@ . . . . . . . . . . . . . . . @ . . . . . . . . . . . . . . . . . . . . . . . . . . . . . . . @ . . . . . . . . . . . . . . . 
@ . . . . . . . . . . . . . . . @ . . . . . . . . . . . . . . . @ . . . . . . . . . . . . . . . @ . . . . . . . . . . . . . . . 
. . . . . . . . . . . . . . . . @ . . . . . . . . . . . . . . . @ . . . . . . . . . . . . . . . @ . . . . . . . . . . . . . . . 
@ . . . . . . . . . . . . . . . @ . . . . . . . . . . . . . . . @ . . . . . . . . . . . . . . . . . . . . . . . . . . . . . . . 
@ . . . . . . . . . . . . . . . @ . . . . . . . . . . . . . . . @ . . . . . . . . . . . . . . . @ . . . . . . . . . . . . . . . 
@ . . . . . . . . . . . . . . . @ . . . . . . . . . . . . . . . @ . . . . . . . . . . . . . . . @ . . . . . . . . . . . . . . . 
@ . . . . . . . . . . . . . . . @ . . . . . . . . . . . . . . . @ . . . . . . . . . . . . . . . @ . . . . . . . . . . . . . . . 
@ . @ @ @ @ . @ @ @ @ @ @ @ @ @ @ @ @ @ @ @ @ @ @ @ @ @ @ @ @ @ @ . . @ @ @ @ @ @ @ @ @ @ @ @ @ @ @ @ @ @ @ @ @ @ . @ . @ @ @ @ 
@ . . . . . . . . . . . . . . . @ . . . . . . . . . . . . . . . @ . . . . . . . . . . . . . . . @ . . . . . . . . . . . . . . . 
@ . . . . . . . . . . . . . . . @ . . . . . . . . . . . . . . . @ . . . . . . . . . . . . . . . @ . . . . . . . . . . . . . . . 
@ . . . . . . . . . . . . . . . @ . . . . . . . . . . . . . . . @ . . . . . . . . . . . . . . . @ . . . . . . . . . . . . . . . 
@ . . . . . . . . . . . . . . . @ . . . . . . . . . . . . . . . @ . . . . . . . . . . . . . . . @ . . . . . . . . . . . . . . . 
@ . . . . . . . . . . . . . . . @ . . . . . . . . . . . . . . . @ . . . . . . . . . . . . . . . @ . . . . . . . . . . . . . . . 
@ . . . . . . . . . . . . . . . @ . . . . . . . . . . . . . . . @ . . . . . . . . . . . . . . . @ . . . . . . . . . . . . . . . 
@ . . . . . . . . . . . . . . . @ . . . . . . . . . . . . . . . @ . . . . . . . . . . . . . . . . . . . . . . . . . . . . . . . 
@ . . . . . . . . . . . . . . . @ . . . . . . . . . . . . . . . @ . . . . . . . . . . . . . . . @ . . . . . . . . . . . . . . . 
@ . . . . . . . . . . . . . . . . . . . . . . . . . . . . . . . @ . . . . . . . . . . . . . . . @ . . . . . . . . . . . . . . . 
. . . . . . . . . . . . . . . . @ . . . . . . . . . . . . . . . @ . . . . . . . . . . . . . . . @ . . . . . . . . . . . . . . . 
@ . . . . . . . . . . . . . . . @ . . . . . . . . . . . . . . . @ . . . . . . . . . . . . . . . @ . . . . . . . . . . . . . . . 
@ . . . . . . . . . . . . . . . @ . . . . . . . . . . . . . . . @ . . . . . . . . . . . . . . . @ . . . . . . . . . . . . . . . 
@ . . . . . . . . . . . . . . . @ . . . . . . . . . . . . . . . @ . . . . . . . . . . . . . . . @ . . . . . . . . . . . . . . . 
@ . . . . . . . . . . . . . . . @ . . . . . . . . . . . . . . . @ . . . . . . . . . . . . . . . . . . . . . . . . . . . . . . . 
. . . . . . . . . . . . . . . . . . . . . . . . . . . . . . . . @ . . . . . . . . . . . . . . . @ . . . . . . . . . . . . . . . 
60 
2 25 45 27 
49 34 54 53 
58 12 51 63 
29 37 30 54 
5 9 29 29 
29 56 33 52 
62 49 1 6 
19 39 60 46 
50 31 23 18 
36 21 14 41 
14 57 49 12 
24 1 44 54 
41 47 23 49 
31 11 44 46 
13 23 53 7 
20 50 10 6 
35 45 1 9 
28 11 6 61 
22 44 43 31 
59 11 29 13 
23 29 33 39 
41 6 25 11 
57 26 13 29 
56 10 10 61 
24 17 55 5 
21 21 10 58 
35 4 36 5 
57 44 56 4 
8 15 17 43 
20 2 10 33 
5 24 38 19 
19 10 37 24 
56 53 44 25 
22 38 24 61 
44 15 26 42 
12 35 59 23 
43 0 53 49 
5 42 35 3 
56 49 2 3 
24 31 17 44 
2 4 34 58 
23 36 17 54 
42 53 1 26 
41 26 21 40 
25 5 3 35 
10 56 62 28 
10 22 31 59 
21 31 5 4 
9 23 61 49 
6 18 5 45 
47 9 3 4 
33 62 26 39 
22 43 14 6 
36 51 31 10 
53 42 45 53 
26 28 26 38 
11 34 5 37 
42 34 25 27 
49 11 27 51 
34 43 5 11 
