10 10
@ @ @ @ @ @ @ @ @ @
@ . . @ . . . . . @
@ . . . . . @ . . @
@ . . . . . . . . @
@ . . . @ . . . . @
@ . . . . . . @ . @
@ . . . . . . . . @
@ . . . . . @ . . @
@ . . . . . . . @ @
@ @ @ @ @ @ @ @ @ @
8
2 3 7 3
8 5 7 4
7 2 6 2
4 2 3 4
3 1 6 8
7 1 2 2
1 7 8 5
3 6 6 3
