10 10
@ @ @ @ @ @ @ @ @ @
@ . . . . . . . . @
@ . . . . . @ . . @
@ . . . . @ @ . . @
@ . @ . @ @ . . . @
@ . . @ @ . . . . @
@ . . . . . . . . @
@ @ @ @ @ . . . . @
@ . . . . . . . . @
@ @ @ @ @ @ @ @ @ @
7
3 8 2 7
3 2 8 7
2 5 2 2
8 7 6 5
8 1 4 6
7 8 2 3
6 6 6 7
