7 5
@ @ @ @ @
@ . . . @
@ @ . @ @
@ @ . @ @
@ . . . @
@ . . . @
@ @ @ @ @
2
2 2 5 3
5 3 1 2