31 31
@@@@@@@@@@@@@@@@@@@@@@@@@@@@@@@
@.............................@
@@....@@@@@@@@..@@..@@@@@@@@..@
@@....@@@@@@@@..@@..@@@@@@@@..@
@@..............@@............@
@@..............@@............@
@@....@@@@@@@@..@@..@@@@@@@@..@
@@....@@@@@@@@......@@@@@@@@..@
@.............................@
@@....@@@@@@@@..@@..@@@@@@@@..@
@@....@@@@@@@@..@@..@@@@@@@@..@
@@..............@@............@
@@..............@@............@
@@....@@@@@@@@..@@..@@@@@@@@..@
@@....@@@@@@@@......@@@@@@@@..@
@.............................@
@@....@@@@@@@@..@@..@@@@@@@@..@
@@....@@@@@@@@..@@..@@@@@@@@..@
@@..............@@............@
@@..............@@............@
@@....@@@@@@@@..@@..@@@@@@@@..@
@@....@@@@@@@@......@@@@@@@@..@
@.............................@
@@....@@@@@@@@..@@..@@@@@@@@..@
@@....@@@@@@@@..@@..@@@@@@@@..@
@@..............@@............@
@@..............@@............@
@@....@@@@@@@@..@@..@@@@@@@@..@
@@....@@@@@@@@......@@@@@@@@..@
@.............................@
@@@@@@@@@@@@@@@@@@@@@@@@@@@@@@@
31
2 2 4 10
3 2 5 15
4 2 11 24
5 2 25 21
6 2 26 21
7 2 26 22
9 2 18 28
10 2 25 27
11 2 26 24
12 2 25 26
13 2 26 20
14 2 29 20
16 2 26 27
17 2 12 22
18 2 5 8
19 2 8 10
20 2 19 24
21 2 28 29
12 10 23 2
26 9 24 2
26 26 25 2
5 26 26 2
26 10 27 2
18 14 28 2
2 18 2 2
4 10 5 2
5 15 9 2
26 23 18 2
29 12 6 2
18 28 10 2
15 17 17 2
