32 32 
@@@@@@@@@@@@@@@@@@@@@@@@@@@@@@@@
@..@..@.........................
@..@..@.........................
@..@..@..@@@@@@@@@@@@@..@@@@..@.
@.....@..............@..@..@..@.
@.....@..............@..@..@..@.
@..@@@@@@@..@@@@@@@@@@..@..@@@@.
@...........@...........@.....@.
@...........@...........@.....@.
@@@@@@@@@@@@@..@@@@..@@@@..@@@@@
@..............@.....@..@..@....
@..............@.....@..@..@....
@..@@@@@@@@@@@@@@@@@@@..@..@@@@.
@..............@.....@.....@....
@..............@.....@.....@....
@..@@@@@@@..@@@@..@..@@@@..@..@@
@..@........@.....@........@..@.
@..@........@.....@........@..@.
@@@@..@@@@..@..@@@@..@@@@@@@..@.
@.....@.....@..@.....@........@.
@.....@.....@..@.....@........@.
@..@..@@@@@@@..@..@@@@..@@@@@@@.
@..@........@..@..@..@..@.......
@..@........@..@..@..@..@.......
@..@@@@..@@@@..@@@@..@..@@@@@@@.
@..@..@.................@.......
@..@..@.................@.......
@..@..@@@@@@@@@@..@@@@@@@..@@@@.
@..@..@........@..@........@..@.
@..@..@........@..@........@..@.
@..@..@@@@..@..@..@@@@..@@@@..@.
@.....@.....@...........@.......
45 
31 17 22 7 
20 7 1 2 
1 19 20 10 
5 12 15 19 
25 25 11 3 
7 8 29 28 
16 23 20 29 
10 14 16 13 
25 11 12 23 
31 4 29 22 
11 2 31 7 
28 13 4 15 
13 5 4 8 
17 5 2 21 
10 13 4 7 
16 16 5 4 
2 14 1 25 
2 28 24 1 
22 25 10 12 
23 2 10 9 
17 25 25 5 
29 31 31 31 
29 14 30 17 
31 3 22 10 
23 29 5 26 
31 30 8 27 
16 24 24 8 
13 9 20 22 
26 2 10 7 
8 21 19 18 
22 13 17 23 
30 31 11 19 
31 25 19 28 
29 16 13 26 
16 6 2 10 
14 23 5 22 
11 29 26 1 
2 31 10 25 
17 8 20 23 
7 4 9 26 
7 23 17 26 
3 28 1 8 
23 19 13 1 
10 17 2 19 
7 6 14 1 
