32 32 
@ @ @ . @ . @ @ @ . @ @ @ . @ @ @ . @ @ @ . @ @ @ . @ @ @ . @ @ 
@ . . . @ . . . . . . . @ . . . @ . . . . . . . @ . . . @ . . . 
@ . . . @ . . . @ . . . @ . . . . . . . @ . . . @ . . . . . . . 
. . . . @ . . . @ . . . . . . . @ . . . @ . . . . . . . @ . . . 
@ @ @ . @ @ . @ @ @ @ . @ @ . @ @ @ @ @ @ @ @ @ @ @ @ . @ @ . @ 
@ . . . . . . . @ . . . . . . . . . . . @ . . . @ . . . @ . . . 
. . . . @ . . . . . . . @ . . . @ . . . @ . . . @ . . . . . . . 
@ . . . @ . . . @ . . . @ . . . @ . . . . . . . @ . . . @ . . . 
@ @ @ @ @ @ . @ @ @ @ @ @ @ . @ @ @ . @ @ @ @ . @ . @ @ @ @ @ . 
. . . . @ . . . . . . . @ . . . . . . . @ . . . . . . . @ . . . 
@ . . . . . . . @ . . . @ . . . @ . . . @ . . . @ . . . . . . . 
@ . . . @ . . . @ . . . . . . . @ . . . . . . . @ . . . @ . . . 
@ @ @ @ @ . @ @ @ . @ @ @ @ @ @ @ @ . @ @ @ . @ @ @ @ . @ @ @ . 
@ . . . @ . . . . . . . @ . . . @ . . . . . . . @ . . . @ . . . 
@ . . . @ . . . @ . . . . . . . . . . . @ . . . @ . . . . . . . 
. . . . @ . . . @ . . . @ . . . @ . . . @ . . . @ . . . @ . . . 
@ @ . @ @ @ . @ @ @ @ . @ @ @ @ @ @ . @ @ @ . @ @ @ @ . @ @ @ . 
. . . . @ . . . @ . . . @ . . . @ . . . . . . . @ . . . @ . . . 
@ . . . @ . . . . . . . @ . . . . . . . @ . . . . . . . . . . . 
@ . . . . . . . @ . . . @ . . . @ . . . @ . . . @ . . . @ . . . 
@ @ . @ @ @ @ @ @ . @ @ @ @ @ @ @ @ @ @ @ @ . @ @ @ @ . @ @ @ . 
@ . . . @ . . . . . . . @ . . . @ . . . . . . . @ . . . @ . . . 
@ . . . . . . . @ . . . @ . . . . . . . @ . . . @ . . . @ . . . 
. . . . @ . . . @ . . . . . . . @ . . . @ . . . @ . . . . . . . 
@ . @ @ @ @ @ @ @ @ @ . @ @ @ . @ . @ @ @ @ @ . @ @ @ . @ @ . @ 
@ . . . @ . . . @ . . . @ . . . @ . . . @ . . . . . . . @ . . . 
. . . . . . . . @ . . . @ . . . @ . . . . . . . @ . . . @ . . . 
@ . . . @ . . . @ . . . . . . . . . . . @ . . . @ . . . @ . . . 
@ @ @ . @ @ @ @ @ @ . @ @ @ @ @ @ @ . @ @ @ @ . @ @ @ . @ @ @ . 
. . . . @ . . . @ . . . @ . . . @ . . . @ . . . @ . . . @ . . . 
@ . . . . . . . . . . . @ . . . @ . . . @ . . . @ . . . @ . . . 
@ . . . @ . . . @ . . . @ . . . . . . . . . . . . . . . . . . . 
80 
21 7 11 23 
7 1 21 20 
28 3 18 28 
4 30 31 31 
1 14 4 14 
23 31 0 25 
1 19 27 26 
29 5 19 2 
18 23 24 23 
1 26 10 2 
9 1 17 0 
15 21 30 21 
5 3 7 27 
9 21 11 17 
21 5 5 21 
27 21 18 9 
17 15 20 31 
2 13 7 20 
25 2 31 21 
16 27 14 13 
4 27 3 26 
1 13 28 23 
7 13 23 27 
31 9 0 13 
14 30 22 14 
11 12 9 26 
14 23 16 2 
18 17 23 17 
18 21 3 13 
19 22 27 15 
3 0 23 3 
26 26 9 16 
7 21 14 15 
1 7 25 3 
29 2 14 14 
14 11 10 31 
7 17 1 3 
2 19 23 12 
3 11 29 7 
18 24 5 18 
7 25 18 2 
22 31 9 30 
26 0 31 29 
15 19 31 3 
1 20 25 21 
18 1 13 23 
2 9 12 5 
25 6 15 7 
6 11 23 0 
30 19 14 10 
13 2 17 22 
29 19 26 20 
2 14 9 0 
14 9 17 21 
13 14 21 3 
11 2 7 6 
12 22 5 5 
2 16 24 27 
30 22 1 5 
2 23 15 0 
26 11 29 13 
19 15 30 31 
21 13 6 26 
31 13 27 30 
9 18 31 14 
3 9 7 30 
29 14 28 18 
2 11 1 9 
19 27 27 11 
5 14 27 5 
26 17 13 27 
4 3 22 23 
25 17 22 22 
5 2 11 19 
17 10 11 15 
19 5 15 29 
11 25 27 6 
10 15 13 29 
5 23 7 26 
6 9 31 11 
