32 32 
@ @ @ . @ . @ @ @ . @ @ @ . @ @ @ . @ @ @ . @ @ @ . @ @ @ . @ @ 
@ . . . @ . . . . . . . @ . . . @ . . . . . . . @ . . . @ . . . 
@ . . . @ . . . @ . . . @ . . . . . . . @ . . . @ . . . . . . . 
. . . . @ . . . @ . . . . . . . @ . . . @ . . . . . . . @ . . . 
@ @ @ . @ @ . @ @ @ @ . @ @ . @ @ @ @ @ @ @ @ @ @ @ @ . @ @ . @ 
@ . . . . . . . @ . . . . . . . . . . . @ . . . @ . . . @ . . . 
. . . . @ . . . . . . . @ . . . @ . . . @ . . . @ . . . . . . . 
@ . . . @ . . . @ . . . @ . . . @ . . . . . . . @ . . . @ . . . 
@ @ @ @ @ @ . @ @ @ @ @ @ @ . @ @ @ . @ @ @ @ . @ . @ @ @ @ @ . 
. . . . @ . . . . . . . @ . . . . . . . @ . . . . . . . @ . . . 
@ . . . . . . . @ . . . @ . . . @ . . . @ . . . @ . . . . . . . 
@ . . . @ . . . @ . . . . . . . @ . . . . . . . @ . . . @ . . . 
@ @ @ @ @ . @ @ @ . @ @ @ @ @ @ @ @ . @ @ @ . @ @ @ @ . @ @ @ . 
@ . . . @ . . . . . . . @ . . . @ . . . . . . . @ . . . @ . . . 
@ . . . @ . . . @ . . . . . . . . . . . @ . . . @ . . . . . . . 
. . . . @ . . . @ . . . @ . . . @ . . . @ . . . @ . . . @ . . . 
@ @ . @ @ @ . @ @ @ @ . @ @ @ @ @ @ . @ @ @ . @ @ @ @ . @ @ @ . 
. . . . @ . . . @ . . . @ . . . @ . . . . . . . @ . . . @ . . . 
@ . . . @ . . . . . . . @ . . . . . . . @ . . . . . . . . . . . 
@ . . . . . . . @ . . . @ . . . @ . . . @ . . . @ . . . @ . . . 
@ @ . @ @ @ @ @ @ . @ @ @ @ @ @ @ @ @ @ @ @ . @ @ @ @ . @ @ @ . 
@ . . . @ . . . . . . . @ . . . @ . . . . . . . @ . . . @ . . . 
@ . . . . . . . @ . . . @ . . . . . . . @ . . . @ . . . @ . . . 
. . . . @ . . . @ . . . . . . . @ . . . @ . . . @ . . . . . . . 
@ . @ @ @ @ @ @ @ @ @ . @ @ @ . @ . @ @ @ @ @ . @ @ @ . @ @ . @ 
@ . . . @ . . . @ . . . @ . . . @ . . . @ . . . . . . . @ . . . 
. . . . . . . . @ . . . @ . . . @ . . . . . . . @ . . . @ . . . 
@ . . . @ . . . @ . . . . . . . . . . . @ . . . @ . . . @ . . . 
@ @ @ . @ @ @ @ @ @ . @ @ @ @ @ @ @ . @ @ @ @ . @ @ @ . @ @ @ . 
. . . . @ . . . @ . . . @ . . . @ . . . @ . . . @ . . . @ . . . 
@ . . . . . . . . . . . @ . . . @ . . . @ . . . @ . . . @ . . . 
@ . . . @ . . . @ . . . @ . . . . . . . . . . . . . . . . . . . 
70 
25 13 3 2 
13 18 18 17 
12 22 9 7 
3 14 19 25 
29 0 6 13 
3 3 1 5 
30 2 13 2 
27 5 10 17 
9 13 27 1 
18 26 15 6 
3 0 22 31 
7 20 26 26 
11 10 23 14 
29 7 15 30 
3 11 30 17 
26 22 25 26 
14 3 17 19 
10 9 7 27 
13 15 10 18 
7 7 16 22 
14 1 27 11 
10 30 17 18 
9 14 3 27 
0 17 21 19 
11 29 15 31 
22 1 18 30 
23 25 1 10 
19 14 13 25 
9 15 12 31 
3 12 23 12 
17 25 19 31 
26 15 27 13 
2 14 15 14 
14 17 2 1 
23 2 17 0 
31 11 24 1 
14 9 1 14 
1 11 18 29 
9 22 29 10 
27 21 22 23 
7 31 10 4 
27 29 13 22 
2 27 13 9 
7 15 25 29 
22 10 24 23 
17 6 18 27 
9 8 0 21 
15 17 23 3 
15 1 30 5 
6 25 26 17 
27 12 6 8 
26 27 4 3 
24 11 2 31 
31 16 27 22 
17 2 31 19 
19 30 22 5 
10 10 21 2 
21 31 6 29 
31 26 7 26 
3 1 6 27 
22 16 21 21 
16 27 27 3 
26 1 31 22 
18 19 23 11 
18 25 5 11 
7 10 5 6 
1 19 4 30 
29 13 28 18 
3 17 21 6 
29 31 10 14 
