32 32 
@ @ @ . @ . @ @ @ . @ @ @ . @ @ @ . @ @ @ . @ @ @ . @ @ @ . @ @ 
@ . . . @ . . . . . . . @ . . . @ . . . . . . . @ . . . @ . . . 
@ . . . @ . . . @ . . . @ . . . . . . . @ . . . @ . . . . . . . 
. . . . @ . . . @ . . . . . . . @ . . . @ . . . . . . . @ . . . 
@ @ @ . @ @ . @ @ @ @ . @ @ . @ @ @ @ @ @ @ @ @ @ @ @ . @ @ . @ 
@ . . . . . . . @ . . . . . . . . . . . @ . . . @ . . . @ . . . 
. . . . @ . . . . . . . @ . . . @ . . . @ . . . @ . . . . . . . 
@ . . . @ . . . @ . . . @ . . . @ . . . . . . . @ . . . @ . . . 
@ @ @ @ @ @ . @ @ @ @ @ @ @ . @ @ @ . @ @ @ @ . @ . @ @ @ @ @ . 
. . . . @ . . . . . . . @ . . . . . . . @ . . . . . . . @ . . . 
@ . . . . . . . @ . . . @ . . . @ . . . @ . . . @ . . . . . . . 
@ . . . @ . . . @ . . . . . . . @ . . . . . . . @ . . . @ . . . 
@ @ @ @ @ . @ @ @ . @ @ @ @ @ @ @ @ . @ @ @ . @ @ @ @ . @ @ @ . 
@ . . . @ . . . . . . . @ . . . @ . . . . . . . @ . . . @ . . . 
@ . . . @ . . . @ . . . . . . . . . . . @ . . . @ . . . . . . . 
. . . . @ . . . @ . . . @ . . . @ . . . @ . . . @ . . . @ . . . 
@ @ . @ @ @ . @ @ @ @ . @ @ @ @ @ @ . @ @ @ . @ @ @ @ . @ @ @ . 
. . . . @ . . . @ . . . @ . . . @ . . . . . . . @ . . . @ . . . 
@ . . . @ . . . . . . . @ . . . . . . . @ . . . . . . . . . . . 
@ . . . . . . . @ . . . @ . . . @ . . . @ . . . @ . . . @ . . . 
@ @ . @ @ @ @ @ @ . @ @ @ @ @ @ @ @ @ @ @ @ . @ @ @ @ . @ @ @ . 
@ . . . @ . . . . . . . @ . . . @ . . . . . . . @ . . . @ . . . 
@ . . . . . . . @ . . . @ . . . . . . . @ . . . @ . . . @ . . . 
. . . . @ . . . @ . . . . . . . @ . . . @ . . . @ . . . . . . . 
@ . @ @ @ @ @ @ @ @ @ . @ @ @ . @ . @ @ @ @ @ . @ @ @ . @ @ . @ 
@ . . . @ . . . @ . . . @ . . . @ . . . @ . . . . . . . @ . . . 
. . . . . . . . @ . . . @ . . . @ . . . . . . . @ . . . @ . . . 
@ . . . @ . . . @ . . . . . . . . . . . @ . . . @ . . . @ . . . 
@ @ @ . @ @ @ @ @ @ . @ @ @ @ @ @ @ . @ @ @ @ . @ @ @ . @ @ @ . 
. . . . @ . . . @ . . . @ . . . @ . . . @ . . . @ . . . @ . . . 
@ . . . . . . . . . . . @ . . . @ . . . @ . . . @ . . . @ . . . 
@ . . . @ . . . @ . . . @ . . . . . . . . . . . . . . . . . . . 
70 
22 9 15 9 
29 1 10 11 
19 14 29 14 
1 7 8 25 
19 9 26 30 
1 18 20 27 
18 16 10 15 
11 15 17 3 
26 17 6 9 
13 25 31 2 
30 6 9 0 
6 1 5 13 
11 12 5 16 
22 13 17 11 
21 13 6 3 
6 2 14 29 
18 8 1 13 
19 15 19 15 
17 18 25 13 
19 11 31 31 
13 15 12 18 
9 14 14 5 
30 25 30 26 
22 5 5 29 
4 27 3 0 
22 17 5 12 
3 12 15 0 
27 19 22 14 
24 1 18 19 
3 29 29 3 
16 11 23 14 
25 17 27 13 
7 11 23 5 
29 27 29 11 
31 5 21 27 
6 28 7 19 
1 30 7 22 
14 15 5 30 
26 11 25 21 
11 2 2 16 
9 29 9 17 
3 13 27 11 
18 18 5 27 
21 23 25 31 
12 22 2 3 
28 3 14 21 
30 10 1 15 
10 31 1 11 
13 8 5 6 
21 1 5 2 
7 21 10 18 
0 29 31 17 
19 17 18 6 
2 25 15 21 
26 0 27 30 
21 25 31 21 
28 31 13 23 
2 18 21 29 
19 10 17 29 
11 29 7 26 
14 13 11 25 
22 23 26 21 
22 26 5 17 
2 21 5 9 
0 25 31 6 
1 22 10 4 
2 9 18 29 
1 19 7 25 
14 22 30 3 
1 25 31 27 
