32 32 
@ @ @ . @ . @ @ @ . @ @ @ . @ @ @ . @ @ @ . @ @ @ . @ @ @ . @ @ 
@ . . . @ . . . . . . . @ . . . @ . . . . . . . @ . . . @ . . . 
@ . . . @ . . . @ . . . @ . . . . . . . @ . . . @ . . . . . . . 
. . . . @ . . . @ . . . . . . . @ . . . @ . . . . . . . @ . . . 
@ @ @ . @ @ . @ @ @ @ . @ @ . @ @ @ @ @ @ @ @ @ @ @ @ . @ @ . @ 
@ . . . . . . . @ . . . . . . . . . . . @ . . . @ . . . @ . . . 
. . . . @ . . . . . . . @ . . . @ . . . @ . . . @ . . . . . . . 
@ . . . @ . . . @ . . . @ . . . @ . . . . . . . @ . . . @ . . . 
@ @ @ @ @ @ . @ @ @ @ @ @ @ . @ @ @ . @ @ @ @ . @ . @ @ @ @ @ . 
. . . . @ . . . . . . . @ . . . . . . . @ . . . . . . . @ . . . 
@ . . . . . . . @ . . . @ . . . @ . . . @ . . . @ . . . . . . . 
@ . . . @ . . . @ . . . . . . . @ . . . . . . . @ . . . @ . . . 
@ @ @ @ @ . @ @ @ . @ @ @ @ @ @ @ @ . @ @ @ . @ @ @ @ . @ @ @ . 
@ . . . @ . . . . . . . @ . . . @ . . . . . . . @ . . . @ . . . 
@ . . . @ . . . @ . . . . . . . . . . . @ . . . @ . . . . . . . 
. . . . @ . . . @ . . . @ . . . @ . . . @ . . . @ . . . @ . . . 
@ @ . @ @ @ . @ @ @ @ . @ @ @ @ @ @ . @ @ @ . @ @ @ @ . @ @ @ . 
. . . . @ . . . @ . . . @ . . . @ . . . . . . . @ . . . @ . . . 
@ . . . @ . . . . . . . @ . . . . . . . @ . . . . . . . . . . . 
@ . . . . . . . @ . . . @ . . . @ . . . @ . . . @ . . . @ . . . 
@ @ . @ @ @ @ @ @ . @ @ @ @ @ @ @ @ @ @ @ @ . @ @ @ @ . @ @ @ . 
@ . . . @ . . . . . . . @ . . . @ . . . . . . . @ . . . @ . . . 
@ . . . . . . . @ . . . @ . . . . . . . @ . . . @ . . . @ . . . 
. . . . @ . . . @ . . . . . . . @ . . . @ . . . @ . . . . . . . 
@ . @ @ @ @ @ @ @ @ @ . @ @ @ . @ . @ @ @ @ @ . @ @ @ . @ @ . @ 
@ . . . @ . . . @ . . . @ . . . @ . . . @ . . . . . . . @ . . . 
. . . . . . . . @ . . . @ . . . @ . . . . . . . @ . . . @ . . . 
@ . . . @ . . . @ . . . . . . . . . . . @ . . . @ . . . @ . . . 
@ @ @ . @ @ @ @ @ @ . @ @ @ @ @ @ @ . @ @ @ @ . @ @ @ . @ @ @ . 
. . . . @ . . . @ . . . @ . . . @ . . . @ . . . @ . . . @ . . . 
@ . . . . . . . . . . . @ . . . @ . . . @ . . . @ . . . @ . . . 
@ . . . @ . . . @ . . . @ . . . . . . . . . . . . . . . . . . . 
50 
16 18 18 31 
23 0 30 2 
2 31 26 19 
17 7 17 30 
19 22 18 7 
31 15 15 22 
28 18 1 2 
17 29 13 15 
21 15 11 21 
30 6 27 2 
29 22 2 2 
13 27 26 15 
25 1 13 25 
25 24 6 11 
13 8 26 11 
27 14 18 5 
25 22 23 18 
11 20 14 5 
23 29 27 16 
18 30 29 31 
6 13 8 14 
23 27 21 7 
21 6 29 21 
7 5 13 26 
0 9 2 16 
29 7 13 11 
5 27 9 16 
2 9 22 2 
22 6 2 28 
18 23 19 11 
9 7 24 15 
26 29 18 1 
22 23 5 7 
18 15 31 18 
31 11 11 3 
11 17 13 23 
5 23 1 25 
27 12 18 11 
31 3 9 0 
21 3 19 5 
1 3 27 19 
13 21 5 15 
22 18 6 30 
25 6 17 14 
13 9 18 17 
3 12 11 15 
25 5 3 30 
27 17 19 31 
24 11 26 22 
25 7 31 7 
