32 32 
@ @ @ . @ . @ @ @ . @ @ @ . @ @ @ . @ @ @ . @ @ @ . @ @ @ . @ @ 
@ . . . @ . . . . . . . @ . . . @ . . . . . . . @ . . . @ . . . 
@ . . . @ . . . @ . . . @ . . . . . . . @ . . . @ . . . . . . . 
. . . . @ . . . @ . . . . . . . @ . . . @ . . . . . . . @ . . . 
@ @ @ . @ @ . @ @ @ @ . @ @ . @ @ @ @ @ @ @ @ @ @ @ @ . @ @ . @ 
@ . . . . . . . @ . . . . . . . . . . . @ . . . @ . . . @ . . . 
. . . . @ . . . . . . . @ . . . @ . . . @ . . . @ . . . . . . . 
@ . . . @ . . . @ . . . @ . . . @ . . . . . . . @ . . . @ . . . 
@ @ @ @ @ @ . @ @ @ @ @ @ @ . @ @ @ . @ @ @ @ . @ . @ @ @ @ @ . 
. . . . @ . . . . . . . @ . . . . . . . @ . . . . . . . @ . . . 
@ . . . . . . . @ . . . @ . . . @ . . . @ . . . @ . . . . . . . 
@ . . . @ . . . @ . . . . . . . @ . . . . . . . @ . . . @ . . . 
@ @ @ @ @ . @ @ @ . @ @ @ @ @ @ @ @ . @ @ @ . @ @ @ @ . @ @ @ . 
@ . . . @ . . . . . . . @ . . . @ . . . . . . . @ . . . @ . . . 
@ . . . @ . . . @ . . . . . . . . . . . @ . . . @ . . . . . . . 
. . . . @ . . . @ . . . @ . . . @ . . . @ . . . @ . . . @ . . . 
@ @ . @ @ @ . @ @ @ @ . @ @ @ @ @ @ . @ @ @ . @ @ @ @ . @ @ @ . 
. . . . @ . . . @ . . . @ . . . @ . . . . . . . @ . . . @ . . . 
@ . . . @ . . . . . . . @ . . . . . . . @ . . . . . . . . . . . 
@ . . . . . . . @ . . . @ . . . @ . . . @ . . . @ . . . @ . . . 
@ @ . @ @ @ @ @ @ . @ @ @ @ @ @ @ @ @ @ @ @ . @ @ @ @ . @ @ @ . 
@ . . . @ . . . . . . . @ . . . @ . . . . . . . @ . . . @ . . . 
@ . . . . . . . @ . . . @ . . . . . . . @ . . . @ . . . @ . . . 
. . . . @ . . . @ . . . . . . . @ . . . @ . . . @ . . . . . . . 
@ . @ @ @ @ @ @ @ @ @ . @ @ @ . @ . @ @ @ @ @ . @ @ @ . @ @ . @ 
@ . . . @ . . . @ . . . @ . . . @ . . . @ . . . . . . . @ . . . 
. . . . . . . . @ . . . @ . . . @ . . . . . . . @ . . . @ . . . 
@ . . . @ . . . @ . . . . . . . . . . . @ . . . @ . . . @ . . . 
@ @ @ . @ @ @ @ @ @ . @ @ @ @ @ @ @ . @ @ @ @ . @ @ @ . @ @ @ . 
. . . . @ . . . @ . . . @ . . . @ . . . @ . . . @ . . . @ . . . 
@ . . . . . . . . . . . @ . . . @ . . . @ . . . @ . . . @ . . . 
@ . . . @ . . . @ . . . @ . . . . . . . . . . . . . . . . . . . 
50 
7 6 24 30 
29 5 12 9 
18 28 26 21 
30 10 25 11 
3 23 29 30 
18 7 2 22 
23 11 5 16 
11 21 0 9 
16 27 1 9 
27 23 30 31 
19 6 12 5 
26 13 10 6 
29 7 17 27 
13 17 30 7 
31 14 25 29 
26 10 9 16 
25 31 2 15 
29 29 22 6 
19 31 17 5 
11 3 13 9 
17 18 11 27 
17 15 18 29 
15 6 31 30 
30 8 15 19 
19 9 30 2 
10 14 7 14 
17 3 29 10 
25 27 29 15 
3 10 11 11 
13 8 29 26 
19 3 16 18 
7 18 9 31 
15 11 17 22 
3 11 15 27 
15 10 17 30 
7 7 3 26 
22 9 17 26 
5 19 9 3 
13 25 29 9 
25 25 3 9 
1 3 14 7 
1 31 26 25 
5 23 26 6 
11 26 19 19 
14 30 21 6 
22 3 5 3 
7 5 30 19 
22 13 11 15 
26 9 14 18 
2 2 7 11 
