32 32 
@ @ @ . @ . @ @ @ . @ @ @ . @ @ @ . @ @ @ . @ @ @ . @ @ @ . @ @ 
@ . . . @ . . . . . . . @ . . . @ . . . . . . . @ . . . @ . . . 
@ . . . @ . . . @ . . . @ . . . . . . . @ . . . @ . . . . . . . 
. . . . @ . . . @ . . . . . . . @ . . . @ . . . . . . . @ . . . 
@ @ @ . @ @ . @ @ @ @ . @ @ . @ @ @ @ @ @ @ @ @ @ @ @ . @ @ . @ 
@ . . . . . . . @ . . . . . . . . . . . @ . . . @ . . . @ . . . 
. . . . @ . . . . . . . @ . . . @ . . . @ . . . @ . . . . . . . 
@ . . . @ . . . @ . . . @ . . . @ . . . . . . . @ . . . @ . . . 
@ @ @ @ @ @ . @ @ @ @ @ @ @ . @ @ @ . @ @ @ @ . @ . @ @ @ @ @ . 
. . . . @ . . . . . . . @ . . . . . . . @ . . . . . . . @ . . . 
@ . . . . . . . @ . . . @ . . . @ . . . @ . . . @ . . . . . . . 
@ . . . @ . . . @ . . . . . . . @ . . . . . . . @ . . . @ . . . 
@ @ @ @ @ . @ @ @ . @ @ @ @ @ @ @ @ . @ @ @ . @ @ @ @ . @ @ @ . 
@ . . . @ . . . . . . . @ . . . @ . . . . . . . @ . . . @ . . . 
@ . . . @ . . . @ . . . . . . . . . . . @ . . . @ . . . . . . . 
. . . . @ . . . @ . . . @ . . . @ . . . @ . . . @ . . . @ . . . 
@ @ . @ @ @ . @ @ @ @ . @ @ @ @ @ @ . @ @ @ . @ @ @ @ . @ @ @ . 
. . . . @ . . . @ . . . @ . . . @ . . . . . . . @ . . . @ . . . 
@ . . . @ . . . . . . . @ . . . . . . . @ . . . . . . . . . . . 
@ . . . . . . . @ . . . @ . . . @ . . . @ . . . @ . . . @ . . . 
@ @ . @ @ @ @ @ @ . @ @ @ @ @ @ @ @ @ @ @ @ . @ @ @ @ . @ @ @ . 
@ . . . @ . . . . . . . @ . . . @ . . . . . . . @ . . . @ . . . 
@ . . . . . . . @ . . . @ . . . . . . . @ . . . @ . . . @ . . . 
. . . . @ . . . @ . . . . . . . @ . . . @ . . . @ . . . . . . . 
@ . @ @ @ @ @ @ @ @ @ . @ @ @ . @ . @ @ @ @ @ . @ @ @ . @ @ . @ 
@ . . . @ . . . @ . . . @ . . . @ . . . @ . . . . . . . @ . . . 
. . . . . . . . @ . . . @ . . . @ . . . . . . . @ . . . @ . . . 
@ . . . @ . . . @ . . . . . . . . . . . @ . . . @ . . . @ . . . 
@ @ @ . @ @ @ @ @ @ . @ @ @ @ @ @ @ . @ @ @ @ . @ @ @ . @ @ @ . 
. . . . @ . . . @ . . . @ . . . @ . . . @ . . . @ . . . @ . . . 
@ . . . . . . . . . . . @ . . . @ . . . @ . . . @ . . . @ . . . 
@ . . . @ . . . @ . . . @ . . . . . . . . . . . . . . . . . . . 
70 
23 27 29 17 
30 13 25 15 
21 27 23 18 
22 30 17 23 
6 17 23 5 
19 10 21 29 
11 10 25 27 
27 12 18 23 
23 30 1 27 
31 10 10 15 
30 27 26 21 
22 3 3 12 
6 10 16 11 
29 15 29 29 
2 15 26 17 
5 26 21 5 
7 25 26 10 
26 6 23 10 
14 27 12 31 
19 9 2 9 
15 26 2 25 
9 8 4 14 
31 2 10 4 
18 29 23 29 
14 6 31 5 
2 3 29 1 
13 15 9 2 
1 6 9 10 
26 7 14 14 
17 9 18 8 
6 15 6 7 
25 14 17 2 
30 8 0 5 
23 25 28 27 
2 22 29 0 
23 0 17 31 
25 9 5 22 
17 7 3 10 
31 6 30 2 
2 1 15 7 
15 13 14 16 
6 29 30 30 
24 1 17 29 
22 1 24 23 
18 16 4 3 
1 23 3 27 
26 2 16 2 
22 15 31 17 
21 1 19 2 
18 27 29 19 
30 19 22 7 
21 8 23 15 
9 7 18 10 
21 10 3 1 
2 10 6 31 
23 31 7 20 
7 7 17 26 
31 16 21 2 
10 1 7 19 
26 0 11 5 
17 1 14 15 
28 10 4 11 
18 25 23 14 
23 19 14 2 
31 26 21 3 
18 6 27 3 
31 21 23 26 
3 9 27 30 
21 6 1 30 
3 24 9 13 
