32 32 
@ @ @ . @ . @ @ @ . @ @ @ . @ @ @ . @ @ @ . @ @ @ . @ @ @ . @ @ 
@ . . . @ . . . . . . . @ . . . @ . . . . . . . @ . . . @ . . . 
@ . . . @ . . . @ . . . @ . . . . . . . @ . . . @ . . . . . . . 
. . . . @ . . . @ . . . . . . . @ . . . @ . . . . . . . @ . . . 
@ @ @ . @ @ . @ @ @ @ . @ @ . @ @ @ @ @ @ @ @ @ @ @ @ . @ @ . @ 
@ . . . . . . . @ . . . . . . . . . . . @ . . . @ . . . @ . . . 
. . . . @ . . . . . . . @ . . . @ . . . @ . . . @ . . . . . . . 
@ . . . @ . . . @ . . . @ . . . @ . . . . . . . @ . . . @ . . . 
@ @ @ @ @ @ . @ @ @ @ @ @ @ . @ @ @ . @ @ @ @ . @ . @ @ @ @ @ . 
. . . . @ . . . . . . . @ . . . . . . . @ . . . . . . . @ . . . 
@ . . . . . . . @ . . . @ . . . @ . . . @ . . . @ . . . . . . . 
@ . . . @ . . . @ . . . . . . . @ . . . . . . . @ . . . @ . . . 
@ @ @ @ @ . @ @ @ . @ @ @ @ @ @ @ @ . @ @ @ . @ @ @ @ . @ @ @ . 
@ . . . @ . . . . . . . @ . . . @ . . . . . . . @ . . . @ . . . 
@ . . . @ . . . @ . . . . . . . . . . . @ . . . @ . . . . . . . 
. . . . @ . . . @ . . . @ . . . @ . . . @ . . . @ . . . @ . . . 
@ @ . @ @ @ . @ @ @ @ . @ @ @ @ @ @ . @ @ @ . @ @ @ @ . @ @ @ . 
. . . . @ . . . @ . . . @ . . . @ . . . . . . . @ . . . @ . . . 
@ . . . @ . . . . . . . @ . . . . . . . @ . . . . . . . . . . . 
@ . . . . . . . @ . . . @ . . . @ . . . @ . . . @ . . . @ . . . 
@ @ . @ @ @ @ @ @ . @ @ @ @ @ @ @ @ @ @ @ @ . @ @ @ @ . @ @ @ . 
@ . . . @ . . . . . . . @ . . . @ . . . . . . . @ . . . @ . . . 
@ . . . . . . . @ . . . @ . . . . . . . @ . . . @ . . . @ . . . 
. . . . @ . . . @ . . . . . . . @ . . . @ . . . @ . . . . . . . 
@ . @ @ @ @ @ @ @ @ @ . @ @ @ . @ . @ @ @ @ @ . @ @ @ . @ @ . @ 
@ . . . @ . . . @ . . . @ . . . @ . . . @ . . . . . . . @ . . . 
. . . . . . . . @ . . . @ . . . @ . . . . . . . @ . . . @ . . . 
@ . . . @ . . . @ . . . . . . . . . . . @ . . . @ . . . @ . . . 
@ @ @ . @ @ @ @ @ @ . @ @ @ @ @ @ @ . @ @ @ @ . @ @ @ . @ @ @ . 
. . . . @ . . . @ . . . @ . . . @ . . . @ . . . @ . . . @ . . . 
@ . . . . . . . . . . . @ . . . @ . . . @ . . . @ . . . @ . . . 
@ . . . @ . . . @ . . . @ . . . . . . . . . . . . . . . . . . . 
70 
29 0 0 17 
21 26 21 30 
2 15 22 3 
18 8 2 5 
27 30 22 1 
13 2 7 31 
18 11 31 28 
16 31 3 7 
4 6 23 26 
1 27 5 7 
7 20 13 15 
30 6 18 15 
27 6 17 3 
30 17 21 20 
29 2 3 30 
31 1 17 25 
21 19 9 23 
11 1 2 28 
31 26 27 29 
31 13 26 6 
27 16 27 23 
21 9 7 23 
27 15 6 8 
7 13 14 19 
19 13 3 2 
24 11 2 21 
13 1 13 9 
9 2 24 17 
18 14 17 21 
19 11 23 12 
30 22 26 27 
31 3 15 30 
25 2 25 22 
25 9 14 22 
21 23 6 18 
15 13 15 19 
0 3 11 2 
1 22 14 10 
25 19 11 14 
7 11 19 7 
21 10 15 17 
24 23 16 27 
20 22 13 14 
14 17 30 3 
25 18 3 19 
14 2 22 2 
30 21 21 25 
27 31 5 22 
14 14 13 26 
1 8 13 3 
26 21 9 29 
18 10 22 7 
14 29 18 26 
4 11 26 11 
25 14 22 16 
11 6 10 4 
3 1 0 9 
19 1 17 14 
10 7 30 23 
11 17 22 15 
31 29 1 10 
2 22 30 15 
26 9 7 10 
22 23 30 13 
30 10 16 22 
21 14 23 19 
25 5 31 22 
7 3 27 3 
26 15 31 15 
27 19 14 28 
